County_name,STCO,LaborForce00,PrimeAge00,Over65_00,55-64_00,Under25_00,LaborForce,PrimeAge,Over65,55-64,Under25,over65_%_16,over65_%_00,over65_%change,NET_LaborTotal,%_LaborTotal,NET_PrimeAge,%_PrimeAge,NET_Over65,%_Over65,NET_55-64,%_55-64,NET_Under25,%_Under25,CSA,CSA_name
Alameda,06001,734555,544706,19829,69158,100862,864007,600176,37369,131049,95413,0.04325080699577665,0.02699457494673646,0.01625623204904019,129452,0.176231868273989,55470,0.10183475122359585,129452,0.884563013767714,61891,0.8949217733306342,-5449,-0.054024310443972955,488,"San Jose-San Francisco-Oakland, CA"
Contra Costa,06013,474669,347450,15212,52312,59695,565656,373193,28760,95945,67758,0.0508436222721937,0.032047595271652456,0.018796027000541247,90987,0.19168515323309507,25743,0.07409123614908619,90987,0.8906126742045753,43633,0.8340916042208288,8063,0.13506993885585059,488,"San Jose-San Francisco-Oakland, CA"
Los Angeles,06037,4312264,3109376,129906,391344,681638,5173061,3536534,223549,742080,670898,0.043214066101288966,0.03012477900239874,0.013089287098890227,860797,0.19961602536393877,427158,0.13737740305450355,860797,0.720852000677413,350736,0.8962345149024898,-10740,-0.015756163828894516,348,"Los Angeles-Long Beach, CA"
Marin,06041,133052,96435,6165,19568,10884,137609,81778,14195,30114,11522,0.1031545901794214,0.046335267414244055,0.056819322765177344,4557,0.0342497670083877,-14657,-0.15198838595945455,4557,1.3025141930251418,10546,0.5389411283728537,638,0.058618155090040425,488,"San Jose-San Francisco-Oakland, CA"
Napa,06055,61208,42299,2463,7207,9239,74844,46797,4746,13204,10097,0.06341189674523008,0.040239837929682394,0.023172058815547687,13636,0.22278133577310155,4498,0.1063382113052318,13636,0.9269183922046285,5997,0.8321076730956015,858,0.09286719341920122,488,"San Jose-San Francisco-Oakland, CA"
Orange,06059,1411901,1020884,43770,141427,205820,1645577,1093411,81966,255086,215114,0.04980988431413419,0.031000757135238234,0.018809127178895955,233676,0.1655045219176132,72527,0.07104333107385365,233676,0.8726525017135024,113659,0.8036584244875448,9294,0.04515596151977456,348,"Los Angeles-Long Beach, CA"
Riverside,06065,654387,461082,23592,61128,108585,1071927,714833,44806,146320,165968,0.04179948821141738,0.036052060936418356,0.005747427274999023,417540,0.6380627977022771,253751,0.5503381177317701,417540,0.8992031197015937,85192,1.39366575055621,57383,0.528461573882212,348,"Los Angeles-Long Beach, CA"
San Benito,06069,25347,18321,710,2237,4079,29883,19546,1223,4542,4572,0.04092627915537262,0.028011204481792718,0.012915074673579902,4536,0.17895608947804473,1225,0.06686316249113039,4536,0.7225352112676057,2305,1.0303978542691103,493,0.12086295660701152,488,"San Jose-San Francisco-Oakland, CA"
San Bernardino,06071,735589,522919,17358,61444,133868,962592,640506,31046,131179,159861,0.032252501579069844,0.02359741649209001,0.008655085086979833,227003,0.3086003189280971,117587,0.22486656633245303,227003,0.7885701117640281,69735,1.1349358765705357,25993,0.19416888278005198,348,"Los Angeles-Long Beach, CA"
San Francisco,06075,448669,345232,13904,38633,50900,521164,387743,21168,68478,43775,0.04061677322301617,0.030989437647798265,0.009627335575217905,72495,0.16157791155618062,42511,0.12313748435834454,72495,0.522439585730725,29845,0.7725260787409728,-7125,-0.13998035363457761,488,"San Jose-San Francisco-Oakland, CA"
San Joaquin,06077,244516,171250,7471,22711,43084,326928,217085,12762,45670,51411,0.03903611804434004,0.03055423775949222,0.00848188028484782,82412,0.33704133880809434,45835,0.26764963503649636,82412,0.7082050595636461,22959,1.0109198185901105,8327,0.19327360505059882,488,"San Jose-San Francisco-Oakland, CA"
San Mateo,06081,373911,275734,13364,40632,44181,419603,283272,22825,70186,43320,0.0543966558866357,0.03574112556196528,0.01865553032467042,45692,0.12220020272203813,7538,0.027337941639406095,45692,0.7079467225381623,29554,0.7273577475881079,-861,-0.01948801521015821,488,"San Jose-San Francisco-Oakland, CA"
Santa Clara,06085,878932,653165,23370,85561,116836,1005037,705612,41456,146467,111502,0.04124823265213121,0.02658908766548493,0.014659144986646284,126105,0.14347526316029,52447,0.08029670910106941,126105,0.773898160034232,60906,0.7118430125875107,-5334,-0.04565373686192612,488,"San Jose-San Francisco-Oakland, CA"
Santa Cruz,06087,137734,97773,3764,12876,23321,142697,83213,8222,25534,25728,0.057618590439883106,0.02732803810242932,0.030290552337453786,4963,0.0360332234597122,-14560,-0.14891636750432125,4963,1.1843783209351753,12658,0.9830692761727244,2407,0.1032116976115947,488,"San Jose-San Francisco-Oakland, CA"
Solano,06095,190243,138285,4398,16874,30686,216959,139466,9943,34746,32804,0.045828935420978156,0.023117801969060624,0.022711133451917533,26716,0.14043092255694034,1181,0.008540333369490545,26716,1.260800363801728,17872,1.0591442455849236,2118,0.06902170370853158,488,"San Jose-San Francisco-Oakland, CA"
Sonoma,06097,240198,170495,8095,25301,36307,263225,161638,18065,48932,34590,0.06862949947763321,0.03370136304215689,0.03492813643547632,23027,0.09586674327013547,-8857,-0.05194873749963342,23027,1.2316244595429278,23631,0.9339947037666495,-1717,-0.04729115597543174,488,"San Jose-San Francisco-Oakland, CA"
Ventura,06111,372020,264932,11605,38576,56907,439178,280037,23747,72603,62791,0.05407146988237116,0.031194559432288587,0.022876910450082572,67158,0.18052255255093813,15105,0.05701463016925098,67158,1.0462731581214995,34027,0.8820769390294484,5884,0.10339677016887201,348,"Los Angeles-Long Beach, CA"
Adams,08001,190881,137924,4181,15593,33183,254614,175398,8361,33163,37692,0.03283794292536938,0.021903699163353083,0.010934243762016297,63733,0.3338886531399144,37474,0.27170035671819265,63733,0.9997608227696724,17570,1.1267876611299943,4509,0.13588283157038242,216,"Denver-Aurora, CO"
Arapahoe,08005,273207,201459,7059,25726,38963,342792,227417,16300,54067,45008,0.04755070129991365,0.025837551746477946,0.021713149553435705,69585,0.2546969879981113,25958,0.1288500389657449,69585,1.3091089389431931,28341,1.1016481380704346,6045,0.15514719092472345,216,"Denver-Aurora, CO"
Boulder,08013,169972,121414,3398,13796,31364,178533,107503,8798,28852,33380,0.049279404927940494,0.019991528016379167,0.029287876911561327,8561,0.05036711929023604,-13911,-0.11457492546164363,8561,1.589170100058858,15056,1.0913308205276893,2016,0.06427751562300726,216,"Denver-Aurora, CO"
Clear Creek,08019,5776,4348,150,724,554,5444,3150,474,1349,471,0.08706833210874357,0.025969529085872575,0.06109880302287099,-332,-0.0574792243767313,-1198,-0.2755289788408464,-332,2.16,625,0.8632596685082873,-83,-0.14981949458483754,216,"Denver-Aurora, CO"
Denver,08031,301714,219052,9973,23958,48731,381214,278291,14587,44263,44073,0.03826459678815573,0.03305448205916862,0.0052101147289871155,79500,0.26349456770318913,59239,0.2704335043733908,79500,0.46264915271232326,20305,0.8475248351281409,-4658,-0.09558597196856211,216,"Denver-Aurora, CO"
Douglas,08035,98970,80688,1570,8019,8693,171294,116288,7117,27581,20308,0.0415484488656929,0.015863392947357786,0.025685055918335115,72324,0.7307668990603213,35600,0.4412056315685108,72324,3.5331210191082802,19562,2.4394562913081432,11615,1.3361325204187278,216,"Denver-Aurora, CO"
Elbert,08039,11056,8490,265,1141,1160,13331,7764,895,3116,1556,0.06713674893106293,0.02396888567293777,0.04316786325812516,2275,0.20577062228654125,-726,-0.08551236749116607,2275,2.3773584905660377,1975,1.730937773882559,396,0.3413793103448276,216,"Denver-Aurora, CO"
Gilpin,08047,3150,2516,68,283,283,3260,2046,185,896,133,0.05674846625766871,0.02158730158730159,0.03516116467036712,110,0.03492063492063492,-470,-0.18680445151033387,110,1.7205882352941178,613,2.166077738515901,-150,-0.5300353356890459,216,"Denver-Aurora, CO"
Jefferson,08059,300673,219841,8416,31042,41374,317010,201784,16850,58905,39471,0.053152897384940535,0.027990541219198264,0.02516235616574227,16337,0.05433477565328446,-18057,-0.08213663511355934,16337,1.002138783269962,27863,0.8975903614457831,-1903,-0.045995069367235464,216,"Denver-Aurora, CO"
Park,08093,8134,6586,131,715,702,9243,5535,611,2440,657,0.06610407876230662,0.016105237275633146,0.04999884148667347,1109,0.13634128350135236,-1051,-0.1595809292438506,1109,3.66412213740458,1725,2.4125874125874125,-45,-0.0641025641025641,216,"Denver-Aurora, CO"
Weld,08123,92841,62861,2523,8405,19052,142756,93388,6248,21827,21293,0.04376698702681499,0.027175493585807994,0.016591493441006994,49915,0.5376396204263203,30527,0.4856270183420563,49915,1.4764169639318272,13422,1.5969066032123735,2241,0.1176254461473861,216,"Denver-Aurora, CO"
Fairfield,09001,448096,322676,20103,54243,51074,510737,321045,32236,92020,65436,0.06311663341406634,0.044863154324073416,0.018253479089992926,62641,0.1397937049203742,-1631,-0.005054605858508225,62641,0.6035417599363279,37777,0.6964400936526373,14362,0.2811998277009829,408,"New York-Newark, NY-NJ-CT-PA"
Litchfield,09005,99482,72360,4016,12415,10691,105511,61725,7844,23346,12596,0.07434295950185289,0.040369112000160835,0.03397384750169206,6029,0.06060392834884703,-10635,-0.14697346600331676,6029,0.953187250996016,10931,0.8804671768022554,1905,0.1781872603124123,408,"New York-Newark, NY-NJ-CT-PA"
New Haven,09009,421514,298581,15880,47372,59681,461510,287465,27891,83051,63103,0.06043422677731793,0.03767371902238122,0.02276050775493671,39996,0.09488652808684883,-11116,-0.037229428530281564,39996,0.756360201511335,35679,0.7531664274254835,3422,0.057338181330741776,408,"New York-Newark, NY-NJ-CT-PA"
Windham,09015,58654,41388,1586,5748,9932,64506,40018,2821,11482,10185,0.04373236598145909,0.027039929075595867,0.016692436905863223,5852,0.09977154158284175,-1370,-0.03310138204310428,5852,0.7786885245901639,5734,0.9975643702157272,253,0.025473217881594845,148,"Boston-Worcester-Providence, MA-RI-NH-CT"
Kent,10001,64387,44643,2109,6360,11275,85082,54239,4164,12998,13681,0.04894102160268917,0.03275505925109106,0.01618596235159811,20695,0.3214158137512231,9596,0.2149497121609211,20695,0.9743954480796586,6638,1.0437106918238994,2406,0.21339246119733923,428,"Philadelphia-Reading-Camden, PA-NJ-DE-MD"
New Castle,10003,263440,187766,7883,25773,42018,290713,190785,13882,47833,38213,0.04775156253762302,0.029923322198603098,0.017828240339019922,27273,0.10352641967810507,3019,0.01607852326832334,27273,0.7610046936445516,22060,0.8559345051022388,-3805,-0.0905564281974392,428,"Philadelphia-Reading-Camden, PA-NJ-DE-MD"
District of Columbia,11001,298225,206426,10559,29125,52115,385056,275457,17420,43591,48588,0.0452401728579739,0.03540615307234471,0.009834019785629193,86831,0.2911593595439685,69031,0.3344103940395105,86831,0.6497774410455536,14466,0.49668669527896997,-3527,-0.06767725223064378,548,"Washington-Baltimore-Arlington, DC-MD-VA-WV-PA"
Broward,12011,803157,589304,35012,83708,95133,998427,664912,54542,166025,112948,0.05462792973347075,0.04359297123725498,0.011034958496215767,195270,0.24312805590936765,75608,0.1283005036449778,195270,0.5578087512852736,82317,0.983382711329861,17815,0.18726414598509455,370,"Miami-Fort Lauderdale-Port St. Lucie, FL"
Indian River,12061,47737,31157,4283,6226,6071,60255,34862,5169,12943,7281,0.08578541199900423,0.08972076167333515,-0.003935349674330915,12518,0.2622284601043216,3705,0.11891388772988414,12518,0.20686434742003268,6717,1.0788628332797945,1210,0.19930818646022072,370,"Miami-Fort Lauderdale-Port St. Lucie, FL"
Martin,12085,53332,35919,3688,7714,6011,68328,38759,6540,14915,8114,0.09571478749560941,0.06915172879321983,0.026563058702389578,14996,0.2811820295507388,2840,0.07906678916450903,14996,0.7733188720173536,7201,0.9334975369458128,2103,0.3498585925802695,370,"Miami-Fort Lauderdale-Port St. Lucie, FL"
Miami-Dade,12086,1010965,705936,45041,116021,143967,1351925,937749,63329,202105,148742,0.04684357490245391,0.044552482034491796,0.0022910928679621134,340960,0.33726192301414987,231813,0.32837679336370434,340960,0.40603006149952264,86084,0.7419691262788634,4775,0.03316732306709176,370,"Miami-Fort Lauderdale-Port St. Lucie, FL"
Okeechobee,12093,14870,9731,768,1643,2728,15186,10052,674,2448,2012,0.044382984327670225,0.051647612642905176,-0.007264628315234951,316,0.02125084061869536,321,0.0329873599835577,316,-0.12239583333333333,805,0.48995739500912966,-716,-0.2624633431085044,370,"Miami-Fort Lauderdale-Port St. Lucie, FL"
Palm Beach,12099,510379,356246,32037,59299,62797,694060,435322,51844,119627,87267,0.07469671209981846,0.06277099959050039,0.011925712509318065,183681,0.3598913748410495,79076,0.22197021159535826,183681,0.6182538939351375,60328,1.0173527378201994,24470,0.3896682962561906,370,"Miami-Fort Lauderdale-Port St. Lucie, FL"
St. Lucie,12111,82208,56462,4435,10338,10973,129683,81717,8951,21959,17056,0.06902215402172991,0.05394852082522382,0.015073633196506092,47475,0.5774985402880498,25255,0.4472919839892317,47475,1.0182638105975197,11621,1.1241052427935772,6083,0.5543607035450652,370,"Miami-Fort Lauderdale-Port St. Lucie, FL"
Barrow,13013,23898,17757,658,1964,3519,35655,24830,1521,4714,4590,0.04265881363062684,0.02753368482718219,0.01512512880344465,11757,0.49196585488325384,7073,0.39832178859041506,11757,1.3115501519756838,2750,1.4002036659877801,1071,0.30434782608695654,122,"Atlanta--Athens-Clarke County--Sandy Springs, GA"
Bartow,13015,38215,28099,873,3661,5582,49070,33136,1758,7315,6861,0.035826370491135115,0.02284443281433992,0.012981937676795195,10855,0.28405076540625407,5037,0.1792590483647105,10855,1.013745704467354,3654,0.9980879541108987,1279,0.22912934432103188,122,"Atlanta--Athens-Clarke County--Sandy Springs, GA"
Butts,13035,8457,5941,174,1046,1296,9499,6054,546,1664,1235,0.05747973470891673,0.020574671869457255,0.036905062839459477,1042,0.1232115407354854,113,0.019020366941592325,1042,2.1379310344827585,618,0.5908221797323135,-61,-0.0470679012345679,122,"Atlanta--Athens-Clarke County--Sandy Springs, GA"
Carroll,13045,42630,28774,989,4130,8737,54324,34277,1977,7262,10808,0.03639275458360945,0.02319962467745719,0.013193129906152262,11694,0.27431386347642506,5503,0.19124904427608258,11694,0.9989888776541962,3132,0.7583535108958838,2071,0.23703788485750257,122,"Atlanta--Athens-Clarke County--Sandy Springs, GA"
Cherokee,13057,77534,58976,1523,6726,10309,120535,82213,5238,17867,15217,0.04345625751856307,0.01964299533108056,0.023813262187482514,43001,0.5546083008744551,23237,0.3940077319587629,43001,2.439264609323703,11141,1.6564079690752305,4908,0.4760888543990688,122,"Atlanta--Athens-Clarke County--Sandy Springs, GA"
Clarke,13059,55218,29954,1192,3781,20291,61444,34759,2264,6367,18054,0.03684655946878458,0.021587163606070485,0.015259395862714097,6226,0.11275308776123728,4805,0.16041263270347866,6226,0.8993288590604027,2586,0.6839460460195715,-2237,-0.11024592183726775,122,"Atlanta--Athens-Clarke County--Sandy Springs, GA"
Clayton,13063,122396,90913,2121,8715,20647,134017,93736,3885,17159,19237,0.028988859622286724,0.017328997679662735,0.01165986194262399,11621,0.09494591326513939,2823,0.031051664778414527,11621,0.8316831683168316,8444,0.9689041881812966,-1410,-0.06829079285126169,122,"Atlanta--Athens-Clarke County--Sandy Springs, GA"
Cobb,13067,343473,258830,6781,28684,49178,403059,273719,16879,60554,51907,0.04187724377820617,0.01974245428316054,0.022134789495045628,59586,0.1734808849603899,14889,0.057524243712089015,59586,1.489160890724082,31870,1.1110723748431182,2729,0.055492293301882954,122,"Atlanta--Athens-Clarke County--Sandy Springs, GA"
Coweta,13077,46015,34276,940,4502,6297,69101,46446,3126,10435,9094,0.045238129694215715,0.020428121264804956,0.02481000842941076,23086,0.5017059654460502,12170,0.35505893336445327,23086,2.325531914893617,5933,1.3178587294535762,2797,0.4441797681435604,122,"Atlanta--Athens-Clarke County--Sandy Springs, GA"
Dawson,13085,8454,6103,294,966,1091,11200,6944,715,1965,1576,0.06383928571428571,0.0347764371894961,0.02906284852478961,2746,0.32481665483794653,841,0.13780108143535966,2746,1.4319727891156462,999,1.0341614906832297,485,0.44454628780934924,122,"Atlanta--Athens-Clarke County--Sandy Springs, GA"
DeKalb,13089,368086,273389,9257,28703,56737,392376,276670,14678,54697,46331,0.03740799641160519,0.025149014089098743,0.01225898232250645,24290,0.06599001320343616,3281,0.012001214386826097,24290,0.5856108890569299,25994,0.905619621642337,-10406,-0.18340765285439836,122,"Atlanta--Athens-Clarke County--Sandy Springs, GA"
Douglas,13097,48921,36341,911,4504,7165,70886,49166,2216,9914,9590,0.031261462065852216,0.01862185973303898,0.012639602332813235,21965,0.44898918664786086,12825,0.3529071847224898,21965,1.4324917672886937,5410,1.2011545293072825,2425,0.33845080251221216,122,"Atlanta--Athens-Clarke County--Sandy Springs, GA"
Fayette,13113,47090,34953,1115,5554,5468,54556,32997,3328,11186,7045,0.06100153970232422,0.023678063283074962,0.037323476419249255,7466,0.15854746230622213,-1956,-0.05596086172860699,7466,1.9847533632286996,5632,1.0140439323010444,1577,0.2884052670080468,122,"Atlanta--Athens-Clarke County--Sandy Springs, GA"
Forsyth,13117,52904,41222,1002,4961,5719,103531,73354,3962,14666,11549,0.03826873110469328,0.018939966732194162,0.01932876437249912,50627,0.9569597761983971,32132,0.7794866818689049,50627,2.9540918163672654,9705,1.956258818786535,5830,1.0194089875852421,122,"Atlanta--Athens-Clarke County--Sandy Springs, GA"
Fulton,13121,431553,313796,11295,34987,71475,532926,376947,19104,67975,68900,0.03584737843527994,0.026172915030135347,0.009674463405144596,101373,0.23490278135014703,63151,0.2012485818812222,101373,0.6913678618857901,32988,0.9428644925257953,-2575,-0.0360265827212312,122,"Atlanta--Athens-Clarke County--Sandy Springs, GA"
Gordon,13129,23282,16080,755,2541,3906,26030,17828,1174,3779,3249,0.04510180560891279,0.03242848552529851,0.012673320083614277,2748,0.11803109698479512,1748,0.10870646766169154,2748,0.5549668874172186,1238,0.48720975993703264,-657,-0.16820276497695852,122,"Atlanta--Athens-Clarke County--Sandy Springs, GA"
Gwinnett,13135,325379,250753,5342,24958,44326,457651,320620,15082,66238,55711,0.032955243187494404,0.016417777422636372,0.016537465764858032,132272,0.4065167082079667,69867,0.2786287701443253,132272,1.8232871583676526,41280,1.6539786841894382,11385,0.256846997247665,122,"Atlanta--Athens-Clarke County--Sandy Springs, GA"
Hall,13139,69294,48550,1988,6535,12221,91543,60458,4210,13463,13412,0.045989316496072886,0.02868935261350189,0.017299963882570997,22249,0.32108119029064563,11908,0.24527291452111225,22249,1.1177062374245472,6928,1.0601377199693955,1191,0.09745520006546109,122,"Atlanta--Athens-Clarke County--Sandy Springs, GA"
Haralson,13143,11751,8159,378,1306,1908,12668,8406,797,1625,1840,0.06291443005999368,0.0321674751085014,0.03074695495149228,917,0.07803591183729044,247,0.03027331780855497,917,1.1084656084656084,319,0.2442572741194487,-68,-0.03563941299790356,122,"Atlanta--Athens-Clarke County--Sandy Springs, GA"
Heard,13149,4902,3614,165,446,677,5226,3482,182,896,666,0.03482587064676617,0.033659730722154224,0.001166139924611946,324,0.06609547123623011,-132,-0.036524626452684006,324,0.10303030303030303,450,1.0089686098654709,-11,-0.01624815361890694,122,"Atlanta--Athens-Clarke County--Sandy Springs, GA"
Henry,13151,63081,48300,1165,5183,8433,105927,74627,3166,14282,13852,0.029888508123519026,0.018468318511120622,0.011420189612398404,42846,0.6792219527274457,26327,0.5450724637681159,42846,1.717596566523605,9099,1.7555469805132162,5419,0.6425945689552947,122,"Atlanta--Athens-Clarke County--Sandy Springs, GA"
Jackson,13157,20237,14370,660,2276,2931,28914,20087,1158,4267,3402,0.04004980286366466,0.032613529673370556,0.007436273190294107,8677,0.42876908632702476,5717,0.3978427279053584,8677,0.7545454545454545,1991,0.874780316344464,471,0.16069600818833163,122,"Atlanta--Athens-Clarke County--Sandy Springs, GA"
Jasper,13159,5517,4047,204,523,743,6159,3994,326,1065,774,0.05293067056340315,0.036976617727025554,0.015954052836377595,642,0.11636759108210984,-53,-0.01309612058314801,642,0.5980392156862745,542,1.0363288718929253,31,0.04172274562584118,122,"Atlanta--Athens-Clarke County--Sandy Springs, GA"
Lamar,13171,7667,5272,312,725,1358,7855,4800,280,1537,1238,0.03564608529598982,0.040693882874657625,-0.005047797578667808,188,0.024520673014216773,-472,-0.08952959028831563,188,-0.10256410256410256,812,1.12,-120,-0.08836524300441827,122,"Atlanta--Athens-Clarke County--Sandy Springs, GA"
Madison,13195,12849,9201,377,1499,1772,12558,8042,669,2140,1707,0.05327281414237936,0.02934080473188575,0.02393200941049361,-291,-0.02264767686201261,-1159,-0.1259645690685795,-291,0.7745358090185677,641,0.4276184122748499,-65,-0.03668171557562077,122,"Atlanta--Athens-Clarke County--Sandy Springs, GA"
Meriwether,13199,9845,7024,334,1127,1360,8848,5641,571,1667,969,0.06453435804701628,0.03392585068562722,0.030608507361389058,-997,-0.10126968004062976,-1383,-0.19689635535307518,-997,0.7095808383233533,540,0.47914818101153506,-391,-0.2875,122,"Atlanta--Athens-Clarke County--Sandy Springs, GA"
Morgan,13211,7812,5464,274,924,1150,8429,5214,551,1590,1074,0.06536955748012813,0.0350742447516641,0.030295312728464023,617,0.0789810547875064,-250,-0.04575402635431918,617,1.010948905109489,666,0.7207792207792207,-76,-0.06608695652173913,122,"Atlanta--Athens-Clarke County--Sandy Springs, GA"
Newton,13217,30745,21955,712,3144,4934,50089,33804,1683,6790,7812,0.03360019165884725,0.023158237111725485,0.010441954547121764,19344,0.6291754756871036,11849,0.5396948303347757,19344,1.3637640449438202,3646,1.1596692111959288,2878,0.5832995541143089,122,"Atlanta--Athens-Clarke County--Sandy Springs, GA"
Oconee,13219,13596,10100,442,1458,1596,17698,11383,1005,3278,2032,0.05678607752288394,0.03250956163577523,0.02427651588710871,4102,0.3017063842306561,1283,0.12702970297029703,4102,1.2737556561085972,1820,1.2482853223593964,436,0.2731829573934837,122,"Atlanta--Athens-Clarke County--Sandy Springs, GA"
Oglethorpe,13221,6190,4460,201,686,843,6706,4511,363,1202,630,0.05413062928720549,0.03247172859450727,0.02165890069269822,516,0.08336025848142165,51,0.011434977578475336,516,0.8059701492537313,516,0.7521865889212828,-213,-0.2526690391459075,122,"Atlanta--Athens-Clarke County--Sandy Springs, GA"
Paulding,13223,42755,33653,502,2929,5671,76573,54779,2012,9562,10220,0.026275580165332428,0.01174131680505204,0.014534263360280388,33818,0.7909718161618524,21126,0.627759783674561,33818,3.00796812749004,6633,2.2645954250597473,4549,0.802151296067713,122,"Atlanta--Athens-Clarke County--Sandy Springs, GA"
Pickens,13227,11542,8108,355,1448,1631,13703,8824,970,2207,1702,0.07078741881339852,0.03075723444810258,0.04003018436529594,2161,0.18722924969675966,716,0.08830784410458806,2161,1.732394366197183,759,0.524171270718232,71,0.043531575720416923,122,"Atlanta--Athens-Clarke County--Sandy Springs, GA"
Pike,13231,6544,4682,258,696,908,8275,5512,334,1341,1088,0.040362537764350455,0.03942542787286064,0.0009371098914898179,1731,0.2645171149144254,830,0.17727466894489535,1731,0.29457364341085274,645,0.9267241379310345,180,0.19823788546255505,122,"Atlanta--Athens-Clarke County--Sandy Springs, GA"
Polk,13233,16937,11978,505,1680,2774,18285,12254,697,2787,2547,0.038118676510801204,0.029816378343272127,0.008302298167529077,1348,0.07958906535986301,276,0.023042244114209385,1348,0.3801980198019802,1107,0.6589285714285714,-227,-0.081831290555155,122,"Atlanta--Athens-Clarke County--Sandy Springs, GA"
Rockdale,13247,35166,25661,836,3525,5144,41941,28064,1501,7249,5127,0.03578836937602823,0.023772962520616503,0.012015406855411727,6775,0.19265768071432635,2403,0.09364405128404972,6775,0.7954545454545454,3724,1.05645390070922,-17,-0.0033048211508553654,122,"Atlanta--Athens-Clarke County--Sandy Springs, GA"
Spalding,13255,27148,19041,932,2598,4577,26819,17804,1350,3823,3842,0.050337447332115294,0.03433033740975394,0.016007109922361352,-329,-0.012118756446147046,-1237,-0.06496507536368888,-329,0.44849785407725323,1225,0.47151655119322555,-735,-0.16058553637753986,122,"Atlanta--Athens-Clarke County--Sandy Springs, GA"
Troup,13285,28151,19458,1098,2793,4802,33077,21323,1347,5139,5268,0.04072316110892765,0.039003943021562286,0.0017192180873653665,4926,0.1749849028453696,1865,0.09584746633775311,4926,0.226775956284153,2346,0.8399570354457573,466,0.09704289879216993,122,"Atlanta--Athens-Clarke County--Sandy Springs, GA"
Upson,13293,12402,8486,342,1547,2027,11235,7066,462,2049,1658,0.041121495327102804,0.027576197387518143,0.013545297939584661,-1167,-0.09409772617319787,-1420,-0.16733443318406788,-1167,0.3508771929824561,502,0.32449903038138334,-369,-0.1820424272323631,122,"Atlanta--Athens-Clarke County--Sandy Springs, GA"
Walton,13297,30409,22465,740,2873,4331,41699,27929,1827,6543,5400,0.04381400033573946,0.02433490085172153,0.019479099484017933,11290,0.3712716629945082,5464,0.24322279100823505,11290,1.468918918918919,3670,1.2774103724329968,1069,0.24682521357654122,122,"Atlanta--Athens-Clarke County--Sandy Springs, GA"
Bureau,17011,18213,12428,841,2241,2703,17376,10351,1078,3578,2369,0.06203959484346225,0.04617580848844232,0.015863786355019928,-837,-0.04595618514248065,-2077,-0.16712262632764724,-837,0.28180737217598095,1337,0.5966086568496207,-334,-0.12356640769515354,176,"Chicago-Naperville, IL-IN-WI"
Cook,17031,2620175,1855520,87102,260202,417351,2759566,1878606,117700,409194,354066,0.0426516343511987,0.033242817750722756,0.009408816600475947,139391,0.053199118379497555,23086,0.012441795291885832,139391,0.3512892930127896,148992,0.5726012866926464,-63285,-0.15163495475031807,176,"Chicago-Naperville, IL-IN-WI"
DeKalb,17037,48904,29628,1309,4005,13962,57748,32682,2064,7511,15491,0.03574149754104038,0.026766726648126942,0.008974770892913441,8844,0.18084410273188287,3054,0.10307816929931146,8844,0.5767761650114591,3506,0.8754057428214732,1529,0.1095115312992408,176,"Chicago-Naperville, IL-IN-WI"
DuPage,17043,492352,357813,13913,52724,67902,514364,326858,27666,93587,66253,0.053786812451882327,0.02825823800857923,0.025528574443303097,22012,0.044707851293383595,-30955,-0.08651166950334392,22012,0.9884999640623877,40863,0.7750360367195205,-1649,-0.02428499896910253,176,"Chicago-Naperville, IL-IN-WI"
Grundy,17063,19468,13721,493,1860,3394,26244,17540,953,3839,3912,0.036313062033226644,0.025323607972056707,0.010989454061169936,6776,0.34805835216765973,3819,0.2783324830551709,6776,0.9330628803245437,1979,1.063978494623656,518,0.15262227460223923,176,"Chicago-Naperville, IL-IN-WI"
Kane,17089,206024,148174,5235,18939,33676,277674,181212,12219,43001,41242,0.044004840208301824,0.025409661010367724,0.0185951791979341,71650,0.3477750165029317,33038,0.22296759215516893,71650,1.3340974212034384,24062,1.270500026400549,7566,0.22467038840717424,176,"Chicago-Naperville, IL-IN-WI"
Kankakee,17091,51561,35150,1784,5206,9421,54797,34365,2719,9219,8494,0.049619504717411535,0.034599794418261866,0.015019710299149669,3236,0.06276061364209383,-785,-0.02233285917496444,3236,0.524103139013453,4013,0.7708413369189396,-927,-0.09839719774970809,176,"Chicago-Naperville, IL-IN-WI"
Kendall,17093,29697,21700,740,3089,4168,66123,46537,2684,8377,8525,0.04059101976619331,0.024918341920059265,0.015672677846134044,36426,1.2265885442974038,24837,1.1445622119815668,36426,2.627027027027027,5288,1.7118808675946908,4357,1.045345489443378,176,"Chicago-Naperville, IL-IN-WI"
Lake,17097,337181,241294,10285,33134,52468,379883,236379,18637,65911,58956,0.049059842109281014,0.030502904967954898,0.018556937141326117,42702,0.12664414661561593,-4915,-0.020369341964574336,42702,0.8120563928050559,32777,0.9892255689020342,6488,0.12365632385453991,176,"Chicago-Naperville, IL-IN-WI"
LaSalle,17099,53979,37288,2138,6006,8547,55899,34796,2922,9755,8426,0.05227284924596147,0.03960799570203227,0.012664853543929197,1920,0.03556938809537042,-2492,-0.06683115211328042,1920,0.3666978484565014,3749,0.6242091242091242,-121,-0.014157014157014158,176,"Chicago-Naperville, IL-IN-WI"
McHenry,17111,140203,104384,3487,13327,19005,170616,109231,7511,30356,23518,0.04402283490411216,0.02487107979144526,0.019151755112666896,30413,0.21692117857677795,4847,0.04643431943592888,30413,1.1540005735589332,17029,1.2777819464245517,4513,0.23746382530912918,176,"Chicago-Naperville, IL-IN-WI"
Putnam,17155,3002,2029,137,392,444,3159,1848,250,701,360,0.07913896802785692,0.04563624250499667,0.033502725522860245,157,0.05229846768820786,-181,-0.08920650566781665,157,0.8248175182481752,309,0.7882653061224489,-84,-0.1891891891891892,176,"Chicago-Naperville, IL-IN-WI"
Will,17197,257898,190805,5323,23186,38584,362694,242521,13441,54567,52165,0.03705878784870993,0.020639942923171176,0.016418844925538755,104796,0.4063466952050811,51716,0.27104111527475694,104796,1.5250798421942513,31381,1.3534460450271715,13581,0.3519852788720713,176,"Chicago-Naperville, IL-IN-WI"
Jasper,18073,14785,9884,502,1585,2814,16257,10257,866,2680,2454,0.05326936089069324,0.03395333107879608,0.019316029811897166,1472,0.0995603652350355,373,0.0377377579927155,1472,0.7250996015936255,1095,0.6908517350157729,-360,-0.1279317697228145,176,"Chicago-Naperville, IL-IN-WI"
Lake,18089,230901,160718,7206,23949,39028,237739,152926,10537,40076,34200,0.0443217141487093,0.031208180129146258,0.013113534019563042,6838,0.02961442349751625,-7792,-0.04848243507261166,6838,0.46225367749097973,16127,0.6733892855651593,-4828,-0.12370605718970995,176,"Chicago-Naperville, IL-IN-WI"
LaPorte,18091,53431,37240,2053,6113,8025,51851,31479,3090,10121,7161,0.059593836184451604,0.038423387172240836,0.021170449012210768,-1580,-0.029570848383896987,-5761,-0.15469924812030075,-1580,0.5051144666341939,4008,0.6556518894159987,-864,-0.10766355140186916,176,"Chicago-Naperville, IL-IN-WI"
Newton,18111,7259,5040,271,849,1099,6790,4169,388,1355,878,0.05714285714285714,0.037332965973274554,0.019809891169582587,-469,-0.06460945033751206,-871,-0.17281746031746031,-469,0.4317343173431734,506,0.5959952885747939,-221,-0.2010919017288444,176,"Chicago-Naperville, IL-IN-WI"
Porter,18127,76960,53356,1982,8439,13183,83782,53233,3785,15339,11425,0.045176768279582724,0.025753638253638255,0.01942313002594447,6822,0.08864345114345114,-123,-0.0023052702601394407,6822,0.9096871846619576,6900,0.8176324209029506,-1758,-0.13335356140483956,176,"Chicago-Naperville, IL-IN-WI"
Anne Arundel,24003,269772,195970,6903,29032,37867,316151,204267,16982,50346,44556,0.05371483879538575,0.02558827454294738,0.028126564252438372,46379,0.1719192503299082,8297,0.042338112976475994,46379,1.4600898160220195,21314,0.7341554147147975,6689,0.17664457179074128,548,"Washington-Baltimore-Arlington, DC-MD-VA-WV-PA"
Baltimore,24005,396897,281937,14797,43007,57156,444124,283693,26787,77167,56477,0.06031423656456305,0.03728171288772654,0.02303252367683651,47227,0.11899056934166799,1756,0.006228341792669994,47227,0.810299385010475,34160,0.794289301741577,-679,-0.011879767653439708,548,"Washington-Baltimore-Arlington, DC-MD-VA-WV-PA"
Calvert,24009,39341,29705,914,3866,4856,49736,31818,2044,8416,7458,0.04109699211838507,0.02323275971632648,0.017864232402058592,10395,0.26422815891817697,2113,0.07113280592492846,10395,1.236323851203501,4550,1.1769270563890326,2602,0.535831960461285,548,"Washington-Baltimore-Arlington, DC-MD-VA-WV-PA"
Carroll,24013,80767,59178,2111,8885,10593,92793,57719,5334,16773,12967,0.05748278426174388,0.026136912352817364,0.031345871908926515,12026,0.14889744573897756,-1459,-0.024654432390415357,12026,1.5267645665561345,7888,0.8877884074282498,2374,0.22411026149343907,548,"Washington-Baltimore-Arlington, DC-MD-VA-WV-PA"
Cecil,24015,44866,32688,1241,4528,6409,53247,33830,2569,9371,7477,0.0482468495877702,0.027660143538536977,0.020586706049233225,8381,0.1868006954040922,1142,0.03493636808614782,8381,1.0701047542304594,4843,1.0695671378091873,1068,0.16664066156966764,428,"Philadelphia-Reading-Camden, PA-NJ-DE-MD"
Charles,24017,64983,48608,1210,6262,8903,83126,57166,3048,12273,10639,0.03666722806342179,0.018620254528107352,0.01804697353531444,18143,0.27919609744086915,8558,0.17606155365371956,18143,1.51900826446281,6011,0.9599169594378792,1736,0.19499045265640796,548,"Washington-Baltimore-Arlington, DC-MD-VA-WV-PA"
Dorchester,24019,15144,10217,777,2055,2095,16952,10080,1316,3333,2223,0.07763095799905616,0.05130744849445325,0.02632350950460291,1808,0.11938721605916534,-137,-0.013409024175393951,1808,0.6936936936936937,1278,0.621897810218978,128,0.06109785202863962,548,"Washington-Baltimore-Arlington, DC-MD-VA-WV-PA"
Frederick,24021,107151,79846,2682,10380,14243,136600,88967,6504,23054,18075,0.04761346998535871,0.025030097712573845,0.022583372272784865,29449,0.2748364457634553,9121,0.11423239736492749,29449,1.425055928411633,12674,1.2210019267822736,3832,0.26904444288422386,548,"Washington-Baltimore-Arlington, DC-MD-VA-WV-PA"
Harford,24025,116981,86121,3407,12295,15158,137757,87691,7275,23552,19239,0.05281038350138287,0.02912438772108291,0.023685995780299958,20776,0.1776014908403929,1570,0.018230164535943612,20776,1.1353096565893748,11257,0.9155754371695811,4081,0.2692307692307692,548,"Washington-Baltimore-Arlington, DC-MD-VA-WV-PA"
Howard,24027,139885,107471,3043,14868,14503,174892,115654,9396,30645,19197,0.05372458431489147,0.021753583300568324,0.03197100101432315,35007,0.25025556707295277,8183,0.0761414707223344,35007,2.087742359513638,15777,1.061138014527845,4694,0.32365717437771496,548,"Washington-Baltimore-Arlington, DC-MD-VA-WV-PA"
Montgomery,24031,477123,353946,18943,55579,48655,582122,381177,37325,102668,60952,0.06411886168191548,0.039702550495364926,0.024416311186550556,104999,0.22006694290570775,27231,0.07693546473190825,104999,0.9703848387267064,47089,0.8472444628366829,12297,0.2527386702291645,548,"Washington-Baltimore-Arlington, DC-MD-VA-WV-PA"
Prince George's,24033,431120,313622,10035,41137,66326,512949,343741,24359,78392,66457,0.0474881518435556,0.023276581926145852,0.024211569917409748,81829,0.18980562256448322,30119,0.09603599237298403,81829,1.4274040857000498,37255,0.9056323990568101,131,0.0019750927238187136,548,"Washington-Baltimore-Arlington, DC-MD-VA-WV-PA"
Queen Anne's,24035,21849,15685,954,2826,2384,26902,15885,2227,5492,3298,0.08278194929745,0.043663325552656874,0.03911862374479313,5053,0.23126916563687125,200,0.012751036021676761,5053,1.3343815513626835,2666,0.943382873319179,914,0.38338926174496646,548,"Washington-Baltimore-Arlington, DC-MD-VA-WV-PA"
St. Mary's,24037,46032,33758,1155,4194,6925,58498,38902,2532,8893,8171,0.04328353106089097,0.02509124087591241,0.018192290184978564,12466,0.27081160931525894,5144,0.1523786954203448,12466,1.1922077922077923,4699,1.120410109680496,1246,0.179927797833935,548,"Washington-Baltimore-Arlington, DC-MD-VA-WV-PA"
Talbot,24041,16789,11512,1156,2532,1589,18741,10414,1904,4066,2357,0.1015954324742543,0.06885460718327477,0.03274082529097953,1952,0.11626660313300376,-1098,-0.09537873523280056,1952,0.6470588235294118,1534,0.6058451816745656,768,0.48332284455632474,548,"Washington-Baltimore-Arlington, DC-MD-VA-WV-PA"
Washington,24043,63714,45258,2339,7055,9062,72795,47148,3588,12131,9928,0.04928909952606635,0.036710926954829394,0.012578172571236959,9081,0.14252754496656936,1890,0.041760572716425824,9081,0.5339888841385207,5076,0.7194897236002835,866,0.0955638931803134,548,"Washington-Baltimore-Arlington, DC-MD-VA-WV-PA"
Baltimore,24510,287159,200148,9656,27804,49551,310850,212209,13456,43584,41601,0.0432877593694708,0.033625970281272746,0.009661789088198057,23691,0.08250133201466783,12061,0.060260407298599036,23691,0.39353769676884837,15780,0.5675442382391023,-7950,-0.16044075800690197,548,"Washington-Baltimore-Arlington, DC-MD-VA-WV-PA"
Barnstable,25001,107184,73636,6958,15008,11582,110966,59088,12508,26103,13267,0.11271921128994467,0.06491640543364681,0.047802805856297856,3782,0.03528511718166891,-14548,-0.19756640773534684,3782,0.7976430008623168,11095,0.7392723880597015,1685,0.1454843723018477,148,"Boston-Worcester-Providence, MA-RI-NH-CT"
Bristol,25005,275122,195320,8608,27985,43209,297355,187497,14730,49701,45427,0.049536749003716095,0.03128793771490466,0.018248811288811437,22233,0.08081142184194648,-7823,-0.040052221994675404,22233,0.7111988847583643,21716,0.7759871359656959,2218,0.05133189844708278,148,"Boston-Worcester-Providence, MA-RI-NH-CT"
Essex,25009,366950,265023,13701,40638,47588,419435,257509,25597,75553,60776,0.06102733439031077,0.03733751192260526,0.023689822467705512,52485,0.1430303856111187,-7514,-0.028352256219271534,52485,0.8682577914020875,34915,0.8591712190560559,13188,0.2771286879045137,148,"Boston-Worcester-Providence, MA-RI-NH-CT"
Middlesex,25017,805662,581972,29690,86184,107816,897811,582672,52428,148494,114217,0.0583953638349274,0.03685168221909436,0.02154368161583304,92149,0.11437674856205207,700,0.0012028070078972872,92149,0.7658470865611317,62310,0.7229880256196045,6401,0.05936966683980114,148,"Boston-Worcester-Providence, MA-RI-NH-CT"
Norfolk,25021,348897,253822,15544,40488,39043,385197,241926,25717,70188,47366,0.06676324062752306,0.04455183048292189,0.022211410144601172,36300,0.10404216717254662,-11896,-0.04686748981569761,36300,0.6544647452393206,29700,0.7335506816834617,8323,0.2131752170683605,148,"Boston-Worcester-Providence, MA-RI-NH-CT"
Plymouth,25023,246330,177475,8024,28544,32287,276892,167315,17673,52251,39653,0.06382632939918813,0.03257418909592823,0.0312521403032599,30562,0.12406933788007957,-10160,-0.05724749964783772,30562,1.2025174476570288,23707,0.8305423206278026,7366,0.22814135720258927,148,"Boston-Worcester-Providence, MA-RI-NH-CT"
Suffolk,25025,355108,245995,8316,27089,73708,447453,304793,15542,51628,75490,0.034734374336522496,0.02341822769410996,0.011316146642412536,92345,0.26004764747626075,58798,0.23902111831541292,92345,0.8689273689273689,24539,0.9058658496068515,1782,0.024176480164975308,148,"Boston-Worcester-Providence, MA-RI-NH-CT"
Worcester,25027,383764,277860,11893,39219,54792,440388,275955,22580,78600,63253,0.051272968382426405,0.030990400350215237,0.02028256803221117,56624,0.14754901449849386,-1905,-0.006855970632692723,56624,0.898595812662911,39381,1.0041306509599939,8461,0.15442035333625348,148,"Boston-Worcester-Providence, MA-RI-NH-CT"
Genesee,26049,207808,150207,4866,17632,35103,186162,123153,6609,27555,28845,0.03550133754471912,0.023415845395749924,0.012085492148969194,-21646,-0.10416345857714814,-27054,-0.18011144620423816,-21646,0.35819975339087545,9923,0.5627835753176044,-6258,-0.17827536108024955,220,"Detroit-Warren-Ann Arbor, MI"
Lapeer,26087,43411,31862,911,3964,6674,41884,26514,1559,7496,6315,0.037221850826091106,0.020985464513602545,0.01623638631248856,-1527,-0.03517541636912303,-5348,-0.16784884815768,-1527,0.7113062568605928,3532,0.8910191725529768,-359,-0.053790830086904405,220,"Detroit-Warren-Ann Arbor, MI"
Lenawee,26091,49250,34123,1770,5010,8347,46751,29367,2080,8320,6984,0.044491026929905246,0.03593908629441624,0.008551940635489003,-2499,-0.050741116751269036,-4756,-0.13937813205169533,-2499,0.1751412429378531,3310,0.6606786427145709,-1363,-0.16329220079070325,220,"Detroit-Warren-Ann Arbor, MI"
Livingston,26093,83868,62306,1995,8679,10888,98615,62447,4649,18122,13397,0.047142929574608326,0.023787380168836744,0.023355549405771583,14747,0.17583583726808794,141,0.0022630244278239657,14747,1.3303258145363408,9443,1.08802857472059,2509,0.23043717854518736,220,"Detroit-Warren-Ann Arbor, MI"
Macomb,26099,408563,293630,11430,41895,61608,442192,290032,16661,72737,62762,0.03767820313348048,0.027976101604893246,0.00970210152858723,33629,0.08231043927129965,-3598,-0.012253516330075265,33629,0.45765529308836395,30842,0.7361737677527151,1154,0.018731333593039867,220,"Detroit-Warren-Ann Arbor, MI"
Monroe,26115,72941,53103,1662,6456,11720,73354,47112,2732,12920,10590,0.0372440494042588,0.022785538997271766,0.014458510406987035,413,0.0056621104728479185,-5991,-0.11281848483136546,413,0.6438026474127557,6464,1.0012391573729864,-1130,-0.09641638225255973,220,"Detroit-Warren-Ann Arbor, MI"
Oakland,26125,637937,469738,20362,66118,81719,660809,424333,34241,116603,85632,0.051816788209603684,0.0319185123295874,0.019898275880016282,22872,0.035853070130749586,-45405,-0.09666026593547893,22872,0.6816128081720852,50485,0.7635590913215766,3913,0.04788360112091435,220,"Detroit-Warren-Ann Arbor, MI"
St. Clair,26147,82376,59256,2161,8124,12835,78175,49570,3108,13728,11769,0.03975695554844899,0.02623336894241041,0.013523586606038581,-4201,-0.05099786345537535,-9686,-0.16346024031321724,-4201,0.43822304488662656,5604,0.689807976366322,-1066,-0.08305414881184262,220,"Detroit-Warren-Ann Arbor, MI"
Washtenaw,26161,179279,121638,4147,14875,38619,192354,113129,8821,27980,42424,0.045858157355708744,0.023131543571751293,0.02272661378395745,13075,0.07293101813374685,-8509,-0.06995346848846577,13075,1.1270798167349891,13105,0.8810084033613446,3805,0.09852663196872007,220,"Detroit-Warren-Ann Arbor, MI"
Wayne,26163,930640,676916,25157,78979,149588,817120,531999,29822,124917,130382,0.03649647542588604,0.02703193501246454,0.009464540413421502,-113520,-0.12198057250924095,-144917,-0.21408416997086788,-113520,0.18543546527805382,45938,0.5816482862533079,-19206,-0.12839265181699067,220,"Detroit-Warren-Ann Arbor, MI"
Anoka,27003,170915,125484,3232,16405,25794,194590,128790,7077,33062,25661,0.036368775373862995,0.01890998449521692,0.017458790878646074,23675,0.13851914694438755,3306,0.02634598833317395,23675,1.1896658415841583,16657,1.0153611703748857,-133,-0.005156237884779406,378,"Minneapolis-St. Paul, MN-WI"
Benton,27009,19602,13213,486,1478,4425,21473,14541,759,3160,3013,0.0353467144786476,0.024793388429752067,0.010553326048895535,1871,0.09544944393429242,1328,0.10050707636418679,1871,0.5617283950617284,1682,1.1380243572395128,-1412,-0.3190960451977401,378,"Minneapolis-St. Paul, MN-WI"
Carver,27019,39072,29531,882,3349,5310,55790,36890,2240,9294,7366,0.04015056461731493,0.022573710073710073,0.017576854543604855,16718,0.4278767403767404,7359,0.24919576038738953,16718,1.5396825396825398,5945,1.7751567632128993,2056,0.3871939736346516,378,"Minneapolis-St. Paul, MN-WI"
Chisago,27025,21840,16150,543,1972,3175,29152,19248,975,4941,3988,0.0334453896816685,0.02486263736263736,0.008582752319031137,7312,0.3347985347985348,3098,0.1918266253869969,7312,0.7955801104972375,2969,1.5055780933062881,813,0.25606299212598427,378,"Minneapolis-St. Paul, MN-WI"
Dakota,27037,206500,153315,4588,18471,30126,238373,155615,10103,40058,32597,0.042383155810431554,0.022217917675544794,0.02016523813488676,31873,0.15434866828087168,2300,0.015001793692724131,31873,1.202048823016565,21587,1.1686968761842889,2471,0.08202217353780787,378,"Minneapolis-St. Paul, MN-WI"
Goodhue,27049,24109,16679,1085,2646,3699,25027,14963,1561,5182,3321,0.06237263755144444,0.04500394043718114,0.017368697114263303,918,0.03807706665560579,-1716,-0.10288386593920498,918,0.43870967741935485,2536,0.9584278155706727,-378,-0.10218978102189781,378,"Minneapolis-St. Paul, MN-WI"
Hennepin,27053,641557,462472,20068,58544,100473,697092,464445,30638,110753,91256,0.04395115709260757,0.03128015125702003,0.012671005835587543,55535,0.08656284632542392,1973,0.004266204224255739,55535,0.526709188758222,52209,0.8917907898332877,-9217,-0.09173608830232997,378,"Minneapolis-St. Paul, MN-WI"
Isanti,27059,17120,12170,443,1735,2772,21003,13786,886,3605,2726,0.042184449840498975,0.025876168224299067,0.016308281616199908,3883,0.22681074766355142,1616,0.13278553820870995,3883,1.0,1870,1.0778097982708934,-46,-0.016594516594516596,378,"Minneapolis-St. Paul, MN-WI"
Le Sueur,27079,13959,9463,628,1724,2144,15384,9575,809,3021,1979,0.052587103484139364,0.04498889605272584,0.007598207431413526,1425,0.10208467655276166,112,0.011835570115185459,1425,0.28821656050955413,1297,0.7523201856148491,-165,-0.07695895522388059,378,"Minneapolis-St. Paul, MN-WI"
McLeod,27085,19191,13377,763,2089,2962,20010,12504,1193,3521,2792,0.05962018990504748,0.039758219998957844,0.019861969906089634,819,0.0426762544942942,-873,-0.065261269342902,819,0.563564875491481,1432,0.6854954523695548,-170,-0.05739365293720459,378,"Minneapolis-St. Paul, MN-WI"
Mille Lacs,27095,11272,7621,460,1370,1821,12808,8229,677,2164,1738,0.05285758900687071,0.040809084457061745,0.012048504549808964,1536,0.13626685592618878,608,0.07977955648864979,1536,0.4717391304347826,794,0.5795620437956205,-83,-0.04557935200439319,378,"Minneapolis-St. Paul, MN-WI"
Ramsey,27123,277129,192258,7689,24880,52302,289955,184915,11379,46059,47602,0.039244020623889916,0.027745201693074345,0.011498818930815571,12826,0.04628169552807537,-7343,-0.03819346919243933,12826,0.47990635973468593,21179,0.8512459807073955,-4700,-0.08986272035486215,378,"Minneapolis-St. Paul, MN-WI"
Rice,27131,31009,19140,926,3162,7781,35678,19903,1788,5839,8148,0.05011491675542351,0.029862298042503788,0.020252618712919723,4669,0.150569189590119,763,0.03986415882967607,4669,0.9308855291576674,2677,0.8466160657811511,367,0.04716617401362293,378,"Minneapolis-St. Paul, MN-WI"
Scott,27139,50862,39278,958,4294,6332,79457,55606,2693,11036,10122,0.03389254565362397,0.018835279776650546,0.015057265876973425,28595,0.562207541976328,16328,0.4157034472223637,28595,1.8110647181628392,6742,1.5700978108989287,3790,0.598547062539482,378,"Minneapolis-St. Paul, MN-WI"
Sherburne,27141,35429,25823,555,2774,6277,50816,34972,1367,7375,7102,0.026900976070528968,0.015665133083067544,0.011235842987461424,15387,0.4343052301786672,9149,0.35429655733261045,15387,1.463063063063063,4601,1.6586157173756308,825,0.13143221284052892,378,"Minneapolis-St. Paul, MN-WI"
Sibley,27143,8192,5423,505,991,1273,8343,5108,529,1654,1052,0.06340644851971713,0.0616455078125,0.0017609407072171346,151,0.0184326171875,-315,-0.058085930296883644,151,0.047524752475247525,663,0.669021190716448,-221,-0.17360565593087196,378,"Minneapolis-St. Paul, MN-WI"
Stearns,27145,75320,47672,2262,6021,19365,88529,50079,3805,13343,21302,0.04298026635339832,0.030031864046733935,0.012948402306664386,13209,0.1753717472118959,2407,0.05049085417016278,13209,0.6821396993810787,7322,1.216077063610696,1937,0.10002581977794991,378,"Minneapolis-St. Paul, MN-WI"
Washington,27163,111853,84320,1903,10704,14926,137937,89410,5768,23731,19028,0.0418161914497198,0.017013401518063888,0.02480278993165591,26084,0.23319893073945266,5090,0.06036527514231499,26084,2.0310036784025223,13027,1.2170216741405082,4102,0.2748224574567868,378,"Minneapolis-St. Paul, MN-WI"
Wright,27171,49527,36328,1241,4622,7336,72899,49613,2656,10447,10183,0.03643397028765827,0.02505703959456458,0.011376930693093687,23372,0.47190421386314535,13285,0.36569588196432506,23372,1.1402095084609185,5825,1.2602769363911726,2847,0.38808615049073064,378,"Minneapolis-St. Paul, MN-WI"
Belknap,33001,29882,21151,1186,3846,3699,32416,19093,2521,7085,3717,0.07777023692003948,0.039689445150926976,0.038080791769112506,2534,0.08480021417575798,-2058,-0.09730036404898114,2534,1.1256323777403034,3239,0.8421736869474779,18,0.004866180048661801,148,"Boston-Worcester-Providence, MA-RI-NH-CT"
Hillsborough,33011,209738,153833,6272,21144,28489,229975,145006,11673,41685,31611,0.05075769105337537,0.029903975436020178,0.02085371561735519,20237,0.09648704574278386,-8827,-0.057380406024715114,20237,0.8611288265306123,20541,0.9714812712826334,3122,0.10958615606023378,148,"Boston-Worcester-Providence, MA-RI-NH-CT"
Merrimack,33013,74113,53022,2532,7936,10623,80609,47857,4989,16289,11474,0.06189135208227369,0.03416404679341006,0.027727305288863628,6496,0.08764993995655283,-5165,-0.09741239485496586,6496,0.9703791469194313,8353,1.0525453629032258,851,0.08010919702532242,148,"Boston-Worcester-Providence, MA-RI-NH-CT"
Rockingham,33015,155700,116493,4636,16757,17814,178340,109549,10540,36029,22222,0.05910059437030391,0.029775208734746306,0.029325385635557605,22640,0.14540783558124598,-6944,-0.05960873185513293,22640,1.27351164797239,19272,1.1500865310019692,4408,0.24744582912316157,148,"Boston-Worcester-Providence, MA-RI-NH-CT"
Strafford,33017,62266,42353,1730,5570,12613,71938,40240,3278,11847,16573,0.04556701604159137,0.027784023383548004,0.017782992658043367,9672,0.1553335688818938,-2113,-0.04989020848582155,9672,0.8947976878612717,6277,1.1269299820466787,3960,0.3139617854594466,148,"Boston-Worcester-Providence, MA-RI-NH-CT"
Atlantic,34001,125696,89989,5586,13790,16331,145218,89698,8423,26230,20867,0.0580024514867303,0.0444405549898167,0.013561896496913597,19522,0.1553112270875764,-291,-0.003233728566824834,19522,0.5078768349445041,12440,0.902102973168963,4536,0.2777539648521217,428,"Philadelphia-Reading-Camden, PA-NJ-DE-MD"
Bergen,34003,453774,326666,22567,59431,45110,494875,317688,34997,94488,47702,0.0707188684011114,0.049731804819139046,0.020987063581972352,41101,0.09057592546069189,-8978,-0.027483729558631754,41101,0.5508042717241991,35057,0.5898773367434504,2592,0.05745954333850588,408,"New York-Newark, NY-NJ-CT-PA"
Burlington,34005,219871,159448,7990,25777,26656,244998,154407,14631,44238,31722,0.059718854847794677,0.03633948997366638,0.023379364874128297,25127,0.11428064637901315,-5041,-0.031615322863880385,25127,0.8311639549436796,18461,0.7161810916708694,5066,0.19005102040816327,428,"Philadelphia-Reading-Camden, PA-NJ-DE-MD"
Camden,34007,250704,180288,9241,26996,34179,268919,174784,14345,44663,35127,0.05334319999702513,0.03686020167209139,0.01648299832493374,18215,0.07265540238687855,-5504,-0.03052893148739794,18215,0.5523211773617573,17667,0.6544302859682916,948,0.027736329325024137,428,"Philadelphia-Reading-Camden, PA-NJ-DE-MD"
Cape May,34009,49201,33591,3031,6997,5582,48081,26778,4665,10123,6515,0.09702377238410183,0.061604438934168004,0.035419333449933824,-1120,-0.022763764964126746,-6813,-0.20282218451370904,-1120,0.5390960079181788,3126,0.44676289838502214,933,0.16714439269079184,428,"Philadelphia-Reading-Camden, PA-NJ-DE-MD"
Cumberland,34011,65642,45670,2786,7374,9812,69044,44789,3373,10403,10479,0.048852905393662015,0.04244233874653423,0.006410566647127781,3402,0.05182657444928552,-881,-0.019290562732647253,3402,0.21069633883704236,3029,0.4107675617032818,667,0.06797798613942112,428,"Philadelphia-Reading-Camden, PA-NJ-DE-MD"
Essex,34013,370939,262814,15117,39685,53323,411519,277788,20215,64502,49014,0.04912288375506356,0.04075333141028579,0.008369552344777771,40580,0.10939804118736504,14974,0.05697565578698243,40580,0.33723622411854204,24817,0.625349628323044,-4309,-0.08080940682257187,408,"New York-Newark, NY-NJ-CT-PA"
Gloucester,34015,132786,95358,3886,13377,20165,157043,100954,7847,27169,21073,0.04996720643390664,0.02926513337249409,0.02070207306141255,24257,0.18267739068877742,5596,0.058684116697078376,24257,1.0193000514668038,13792,1.0310233983703372,908,0.0450285147532854,428,"Philadelphia-Reading-Camden, PA-NJ-DE-MD"
Hudson,34017,297702,216462,8254,27156,45830,376411,279366,12265,45957,38823,0.03258406369633193,0.02772571228947068,0.004858351406861253,78709,0.26438854962344893,62904,0.2906006597000859,78709,0.4859462078992004,18801,0.6923331860362351,-7007,-0.15289111935413485,408,"New York-Newark, NY-NJ-CT-PA"
Hunterdon,34019,65107,48590,2071,8483,5963,69979,41249,4862,16556,7312,0.06947798625301876,0.031809175664675074,0.03766881058834369,4872,0.07483066336953016,-7341,-0.15108046923235233,4872,1.3476581361661033,8073,0.9516680419662855,1349,0.22622840851920176,408,"New York-Newark, NY-NJ-CT-PA"
Mercer,34021,180299,126218,6013,19675,28393,196020,124720,10835,31898,28567,0.055274971941638606,0.03335015723880887,0.02192481470282974,15721,0.08719404988380412,-1498,-0.0118683547513033,15721,0.8019291535007483,12223,0.6212452350698856,174,0.006128271052724263,408,"New York-Newark, NY-NJ-CT-PA"
Middlesex,34023,391203,282172,11678,40334,57019,433873,293746,20968,72461,46698,0.048327505975250824,0.029851509318691318,0.018475996656559506,42670,0.1090738056712244,11574,0.04101753540393802,42670,0.7955129302962836,32127,0.796524024396291,-10321,-0.1810098388256546,408,"New York-Newark, NY-NJ-CT-PA"
Monmouth,34025,311406,226700,11752,36268,36686,332595,207607,21543,65312,38133,0.06477247102331665,0.03773851499328851,0.027033956030028145,21189,0.06804300495173503,-19093,-0.08422143802382002,21189,0.8331347855684139,29044,0.8008161464652035,1447,0.03944283923022406,408,"New York-Newark, NY-NJ-CT-PA"
Morris,34027,252892,185077,9169,32663,25983,276096,174004,17974,53178,30940,0.06510054473806212,0.03625658383816016,0.02884396089990196,23204,0.09175458298404061,-11073,-0.05982915219070981,23204,0.9603010142872723,20515,0.6280807029360438,4957,0.1907785859985375,408,"New York-Newark, NY-NJ-CT-PA"
Ocean,34029,225604,158646,9585,27232,30141,270984,166632,19619,49419,35314,0.07239910843444632,0.04248594883069449,0.029913159603751828,45380,0.20114891579936525,7986,0.050338489467115465,45380,1.0468440271257173,22187,0.8147400117508813,5173,0.17162668790020238,408,"New York-Newark, NY-NJ-CT-PA"
Passaic,34031,232485,164561,7836,25164,34924,252174,164008,13256,41520,33390,0.05256687842521433,0.033705400348409575,0.018861478076804758,19689,0.08468933479579328,-553,-0.0033604560011181264,19689,0.6916794282797346,16356,0.6499761564139247,-1534,-0.043923949146718586,408,"New York-Newark, NY-NJ-CT-PA"
Salem,34033,31471,22384,1125,3450,4512,32133,20141,1930,5891,4171,0.06006286372265272,0.03574719583108259,0.024315667891570136,662,0.021035238791268153,-2243,-0.10020550393137956,662,0.7155555555555555,2441,0.707536231884058,-341,-0.07557624113475177,428,"Philadelphia-Reading-Camden, PA-NJ-DE-MD"
Somerset,34035,158972,121596,5170,17713,14493,182040,118309,10232,34373,19126,0.056207426939134254,0.03252145031829504,0.02368597662083921,23068,0.14510731449563447,-3287,-0.02703213921510576,23068,0.979110251450677,16660,0.9405521368486423,4633,0.3196715655833851,408,"New York-Newark, NY-NJ-CT-PA"
Sussex,34037,76705,57898,1880,8714,8213,81515,49356,5014,16612,10533,0.06151015150585782,0.024509484388240663,0.03700066711761715,4810,0.06270777654650936,-8542,-0.14753532073646758,4810,1.6670212765957446,7898,0.9063575854946064,2320,0.2824789967125289,408,"New York-Newark, NY-NJ-CT-PA"
Union,34039,258641,187257,10176,28168,33040,297293,197676,14964,47890,36763,0.05033418210317767,0.03934411017588085,0.01099007192729682,38652,0.14944266376947196,10419,0.055640109582018295,38652,0.4705188679245283,19722,0.7001562056234024,3723,0.112681598062954,408,"New York-Newark, NY-NJ-CT-PA"
Warren,34041,53293,39789,1712,5779,6013,58803,36366,3609,10903,7925,0.061374419672465694,0.03212429399733548,0.02925012567513021,5510,0.1033906892087141,-3423,-0.08602880193018171,5510,1.1080607476635513,5124,0.8866585914518083,1912,0.3179777149509396,408,"New York-Newark, NY-NJ-CT-PA"
Bronx,36005,500716,358133,11966,46189,84428,659777,456945,21592,84799,96441,0.032726209006982664,0.023897778381357895,0.008828430625624769,159061,0.3176671007117807,98812,0.2759086708010711,159061,0.8044459301353836,38610,0.8359133126934984,12013,0.1422869190316009,408,"New York-Newark, NY-NJ-CT-PA"
Dutchess,36027,138815,97981,4367,14487,21980,156286,94910,9229,28179,23968,0.05905199442048552,0.03145913626049058,0.02759285815999494,17471,0.1258581565392789,-3071,-0.03134281136138639,17471,1.1133501259445844,13692,0.9451232139159246,1988,0.09044585987261146,408,"New York-Newark, NY-NJ-CT-PA"
Kings,36047,1039512,757162,28631,98347,155372,1311082,936988,48757,182448,142889,0.03718836808071501,0.02754273158943812,0.00964563649127689,271570,0.2612475854054595,179826,0.23750003301803313,271570,0.7029443610072997,84101,0.8551455560413638,-12483,-0.08034266148340756,408,"New York-Newark, NY-NJ-CT-PA"
Nassau,36059,655809,468007,33447,80086,74269,714021,446413,50076,136597,80935,0.07013239106412837,0.05100112990215139,0.019131261161976984,58212,0.08876364917224375,-21594,-0.046140335507802235,58212,0.4971746344963674,56511,0.7056289488799541,6666,0.08975481021691419,408,"New York-Newark, NY-NJ-CT-PA"
New York,36061,841633,618808,35304,84478,103043,959120,692455,57138,122024,87503,0.05957335891233631,0.04194702441563009,0.01762633449670622,117487,0.13959409861542976,73647,0.11901429845767993,117487,0.6184568320870156,37546,0.4444470749781008,-15540,-0.1508108265481401,408,"New York-Newark, NY-NJ-CT-PA"
Orange,36071,164858,117862,4951,16856,25189,188573,117660,9347,30947,30619,0.04956701118399771,0.030031906246587973,0.019535104937409734,23715,0.1438510718315156,-202,-0.0017138687617722422,23715,0.8879014340537266,14091,0.8359634551495017,5430,0.21557028861804756,408,"New York-Newark, NY-NJ-CT-PA"
Putnam,36079,50709,38050,1504,6051,5104,54636,33876,3498,10626,6636,0.06402372062376455,0.0296594292926305,0.03436429133113404,3927,0.07744187422351062,-4174,-0.10969776609724047,3927,1.3257978723404256,4575,0.7560733763014378,1532,0.3001567398119122,408,"New York-Newark, NY-NJ-CT-PA"
Queens,36081,1037238,759684,32186,107772,137596,1215483,850262,50431,189264,125526,0.04149050212960609,0.031030486734963433,0.010460015394642655,178245,0.17184580588061757,90578,0.1192311540061394,178245,0.566861368296775,81492,0.7561518761830531,-12070,-0.08772057327247886,408,"New York-Newark, NY-NJ-CT-PA"
Richmond,36085,207766,153570,4758,22615,26823,223845,149972,10771,39257,23845,0.04811811744734079,0.022900763358778626,0.025217354088562165,16079,0.07738994830723026,-3598,-0.023429055154001434,16079,1.2637662883564522,16642,0.7358832633208048,-2978,-0.11102412109010923,408,"New York-Newark, NY-NJ-CT-PA"
Rockland,36087,140516,98911,6171,19180,16254,158875,97490,11187,28554,21644,0.0704138473642801,0.043916706994221295,0.0264971403700588,18359,0.13065416038031255,-1421,-0.01436645064755184,18359,0.8128342245989305,9374,0.4887382690302398,5390,0.33161068044788977,408,"New York-Newark, NY-NJ-CT-PA"
Suffolk,36103,711625,516802,23703,81393,89727,785391,501163,45696,137962,100570,0.0581824849024244,0.03330827331810996,0.024874211584314437,73766,0.10365852801686282,-15639,-0.030261105800674145,73766,0.9278572332616124,56569,0.695010627449535,10843,0.12084433893922676,408,"New York-Newark, NY-NJ-CT-PA"
Sullivan,36105,33330,23518,1292,4216,4304,36332,22674,2557,6575,4526,0.07037872949466036,0.038763876387638764,0.03161485310702159,3002,0.09006900690069007,-844,-0.03588740539161493,3002,0.9791021671826625,2359,0.5595351043643264,222,0.05157992565055762,408,"New York-Newark, NY-NJ-CT-PA"
Ulster,36111,89555,63668,3254,10113,12520,93837,55802,7083,18056,12896,0.07548195274785,0.03633521299759924,0.03914673975025076,4282,0.047814192395734464,-7866,-0.12354715084500849,4282,1.1767055931161647,7943,0.7854247008800553,376,0.030031948881789138,408,"New York-Newark, NY-NJ-CT-PA"
Westchester,36119,452517,326056,22810,57059,46592,506693,322202,35167,91328,57996,0.06940494540086403,0.05040694603738644,0.01899799936347759,54176,0.11972146902768294,-3854,-0.011820055450597444,54176,0.5417360806663744,34269,0.600588864158152,11404,0.24476304945054944,408,"New York-Newark, NY-NJ-CT-PA"
Bryan,40013,16730,10640,677,1774,3639,19796,12514,1130,2981,3171,0.057082238836128514,0.040466228332337116,0.016616010503791398,3066,0.18326359832635983,1874,0.1761278195488722,3066,0.6691285081240768,1207,0.6803833145434047,-468,-0.12860676009892827,206,"Dallas-Fort Worth, TX-OK"
Berks,42011,190703,132917,7773,21124,28889,216959,134110,11739,37786,33324,0.054106997174581374,0.040759715368924455,0.013347281805656919,26256,0.13768005747156573,1193,0.008975526080185378,26256,0.5102277113083752,16662,0.7887710660859686,4435,0.15351864031292187,428,"Philadelphia-Reading-Camden, PA-NJ-DE-MD"
Bucks,42017,320110,231698,11762,36295,40355,344588,210284,22101,69220,42983,0.06413746270909028,0.03674361938083784,0.02739384332825244,24478,0.07646746430914374,-21414,-0.09242203212802873,24478,0.8790171739500086,32925,0.9071497451439592,2628,0.06512204187832982,428,"Philadelphia-Reading-Camden, PA-NJ-DE-MD"
Chester,42029,229631,165238,8329,25199,30865,279408,172961,17156,52914,36377,0.06140124835366203,0.036271235155532135,0.025130013198129894,49777,0.21676951282710086,7723,0.046738643653396916,49777,1.059791091367511,27715,1.099845231953649,5512,0.17858415681192288,428,"Philadelphia-Reading-Camden, PA-NJ-DE-MD"
Delaware,42045,272268,192370,11676,29572,38650,293409,182357,17920,54465,38667,0.06107515447719736,0.042884217021464145,0.018190937455733212,21141,0.07764775882586275,-10013,-0.05205073556167802,21141,0.5347721822541966,24893,0.8417760043284188,17,0.00043984476067270375,428,"Philadelphia-Reading-Camden, PA-NJ-DE-MD"
Franklin,42055,65289,45627,2327,7368,9967,76747,49052,4392,12940,10363,0.057226992586029424,0.03564153226424053,0.021585460321788895,11458,0.17549663802478213,3425,0.07506520262125496,11458,0.8874086807047701,5572,0.756243213897937,396,0.039731112671817,548,"Washington-Baltimore-Arlington, DC-MD-VA-WV-PA"
Montgomery,42091,403574,286346,20557,46930,49741,447741,282052,30920,84053,50716,0.06905778117259755,0.0509373745583214,0.01812040661427615,44167,0.10943965666767433,-4294,-0.014995844188499228,44167,0.5041105219633215,37123,0.791029192414234,975,0.019601535956253392,428,"Philadelphia-Reading-Camden, PA-NJ-DE-MD"
Philadelphia,42101,656935,454183,22921,62510,117321,748923,511674,28509,98970,109770,0.03806666372911501,0.03489081872635801,0.0031758450027569995,91988,0.14002602997252392,57491,0.12658113579768507,91988,0.24379390078966887,36460,0.583266677331627,-7551,-0.064361878947503,428,"Philadelphia-Reading-Camden, PA-NJ-DE-MD"
Bristol,44001,26200,18131,931,3085,4053,26393,15568,1776,5340,3709,0.06729056946917743,0.03553435114503817,0.03175621832413926,193,0.007366412213740458,-2563,-0.1413601014836468,193,0.907626208378088,2255,0.7309562398703403,-344,-0.0848754009375771,148,"Boston-Worcester-Providence, MA-RI-NH-CT"
Kent,44003,89909,64562,3528,9986,11833,93842,58632,5571,17996,11643,0.059365742418107034,0.03923967567206842,0.02012606674603861,3933,0.04374423027728036,-5930,-0.0918496948669496,3933,0.5790816326530612,8010,0.8021229721610255,-190,-0.016056790332122033,148,"Boston-Worcester-Providence, MA-RI-NH-CT"
Newport,44005,46750,33088,1859,5339,6464,46506,27069,3584,8747,7106,0.07706532490431342,0.03976470588235294,0.03730061902196048,-244,-0.005219251336898396,-6019,-0.18190884912959382,-244,0.9279182356105433,3408,0.6383217831054505,642,0.09931930693069307,148,"Boston-Worcester-Providence, MA-RI-NH-CT"
Providence,44007,303889,209315,10605,29366,54603,331586,211140,15424,52269,52753,0.04651583601237688,0.03489761064072737,0.011618225371649513,27697,0.09114183139238341,1825,0.008718916465614027,27697,0.4544082979726544,22903,0.7799155485936117,-1850,-0.03388092229364687,148,"Boston-Worcester-Providence, MA-RI-NH-CT"
Washington,44009,67605,46356,2219,7400,11630,68958,37765,4813,14001,12379,0.06979610777574756,0.0328230160491088,0.03697309172663876,1353,0.020013312624805858,-8591,-0.18532660281301233,1353,1.1689950428120774,6601,0.8920270270270271,749,0.06440240756663801,148,"Boston-Worcester-Providence, MA-RI-NH-CT"
Austin,48015,11268,7645,494,1368,1761,14233,8286,1030,2764,2153,0.07236703435677651,0.04384096556620518,0.028526068790571325,2965,0.2631345402910898,641,0.08384565075212558,2965,1.0850202429149798,1396,1.0204678362573099,392,0.2226007950028393,288,"Houston-The Woodlands, TX"
Brazoria,48039,112904,83121,2648,10635,16500,166197,114792,7078,23786,20541,0.04258801302069231,0.023453553461347695,0.019134459559344615,53293,0.47202047757386806,31671,0.38102284621214855,53293,1.6729607250755287,13151,1.2365773389750823,4041,0.2449090909090909,288,"Houston-The Woodlands, TX"
Chambers,48071,12353,9110,264,1216,1763,17077,11829,610,2360,2278,0.03572055981729812,0.0213713268032057,0.014349233014092418,4724,0.3824172265846353,2719,0.29846322722283203,4724,1.3106060606060606,1144,0.9407894736842105,515,0.29211571185479296,288,"Houston-The Woodlands, TX"
Collin,48085,275351,213963,5165,23593,32630,480241,335736,20632,69219,54654,0.04296176294818643,0.018757876310599924,0.02420388663758651,204890,0.7441047971498197,121773,0.5691311114538495,204890,2.9945788964181994,45626,1.93387869283262,22024,0.6749616916947594,206,"Dallas-Fort Worth, TX-OK"
Cooke,48097,17255,11548,804,2138,2765,19739,11792,1308,3676,2963,0.06626475505344749,0.04659518980005795,0.01966956525338954,2484,0.14395827296435815,244,0.02112919986144787,2484,0.6268656716417911,1538,0.7193638914873713,198,0.07160940325497288,206,"Dallas-Fort Worth, TX-OK"
Dallas,48113,1123518,807695,32248,96334,187241,1307358,889154,54438,176623,187143,0.04163970389135952,0.028702699912239945,0.012937003979119576,183840,0.1636288871206336,81459,0.1008536638211206,183840,0.6881046886628628,80289,0.8334440592106629,-98,-0.0005233896422257945,206,"Dallas-Fort Worth, TX-OK"
Denton,48121,248793,182240,4427,18171,43955,424430,294390,14975,56563,58502,0.03528261432980703,0.01779390899261635,0.017488705337190682,175637,0.7059563572930107,112150,0.6153972783143108,175637,2.3826519087418117,38392,2.112817126190083,14547,0.33095211011261516,206,"Dallas-Fort Worth, TX-OK"
Ellis,48139,56473,39657,1669,5664,9483,80777,52612,3629,12875,11661,0.044926154722260046,0.029553946133550547,0.0153722085887095,24304,0.43036495316345863,12955,0.3266762488337494,24304,1.1743559017375673,7211,1.2731285310734464,2178,0.22967415374881367,206,"Dallas-Fort Worth, TX-OK"
Fort Bend,48157,174803,134862,3557,15314,21070,344382,235369,14184,56178,38651,0.041186821610885584,0.02034862101909006,0.020838200591795523,169579,0.9701149293776422,100507,0.7452581157034598,169579,2.987630025302221,40864,2.6684079926864306,17581,0.8344091124822022,288,"Houston-The Woodlands, TX"
Galveston,48167,122894,88356,3644,12841,18053,158024,103340,8066,25788,20830,0.051042879562598086,0.029651569645385453,0.021391309917212633,35130,0.2858561036340261,14984,0.16958667209923492,35130,1.2135016465422612,12947,1.0082548088155128,2777,0.15382484905555863,288,"Houston-The Woodlands, TX"
Grayson,48181,53380,36532,2030,5918,8900,60174,37196,3610,10621,8747,0.059992687871838334,0.038029224428624955,0.021963463443213378,6794,0.1272761333832896,664,0.018175845833789554,6794,0.7783251231527094,4703,0.7946941534302129,-153,-0.017191011235955057,206,"Dallas-Fort Worth, TX-OK"
Harris,48201,1653892,1204014,40111,143038,266729,2291752,1568329,90911,316340,316172,0.03966877742443336,0.02425249048910086,0.0154162869353325,637860,0.38567209950831133,364315,0.30258369088731524,637860,1.2664855027299244,173302,1.211580139543338,49443,0.18536792024864188,288,"Houston-The Woodlands, TX"
Henderson,48213,31663,20828,1620,4320,4895,32956,20496,2334,6049,4077,0.07082170166282316,0.051163818968512145,0.019657882694311013,1293,0.040836307361905064,-332,-0.015940080660649125,1293,0.44074074074074077,1729,0.40023148148148147,-818,-0.16710929519918283,206,"Dallas-Fort Worth, TX-OK"
Hood,48221,19150,12757,961,2880,2552,23291,13391,2000,5003,2897,0.08587007857112189,0.05018276762402089,0.035687310947101,4141,0.2162402088772846,634,0.04969820490710982,4141,1.081165452653486,2123,0.7371527777777778,345,0.13518808777429467,206,"Dallas-Fort Worth, TX-OK"
Hopkins,48223,15185,10272,625,1884,2404,16305,10246,1234,2748,2077,0.07568230604109169,0.04115903852486006,0.03452326751623163,1120,0.07375699703654923,-26,-0.0025311526479750777,1120,0.9744,864,0.4585987261146497,-327,-0.1360232945091514,206,"Dallas-Fort Worth, TX-OK"
Hunt,48231,36737,24830,1204,4034,6669,40765,25678,2128,6634,6325,0.052201643566785236,0.03277349810817432,0.019428145458610914,4028,0.109644227890138,848,0.03415223519935562,4028,0.7674418604651163,2600,0.6445215666831928,-344,-0.05158194631878842,206,"Dallas-Fort Worth, TX-OK"
Johnson,48251,62376,44050,1689,6701,9936,75332,49801,3385,12322,9824,0.044934423618117135,0.02707772220084648,0.017856701417270655,12956,0.20770809285622677,5751,0.13055618615209988,12956,1.0041444641799881,5621,0.8388300253693478,-112,-0.011272141706924315,206,"Dallas-Fort Worth, TX-OK"
Kaufman,48257,34843,24848,1081,3827,5087,55002,37055,2317,8149,7481,0.04212574088214974,0.031024883046809976,0.011100857835339761,20159,0.5785667135436099,12207,0.4912669027688345,20159,1.1433857539315448,4322,1.1293441337862555,2394,0.4706113622960488,206,"Dallas-Fort Worth, TX-OK"
Liberty,48291,28548,20083,1023,2925,4517,31313,19479,1799,5118,4917,0.057452176412352694,0.03583438419503993,0.021617792217312762,2765,0.09685442062491242,-604,-0.03007518796992481,2765,0.7585532746823069,2193,0.7497435897435898,400,0.08855435023245517,288,"Houston-The Woodlands, TX"
Matagorda,48321,16438,11524,738,1591,2585,17189,10455,938,2860,2936,0.054569783000756295,0.044895972746076165,0.009673810254680129,751,0.04568682321450298,-1069,-0.09276292953835474,751,0.27100271002710025,1269,0.7976115650534256,351,0.1357833655705996,288,"Houston-The Woodlands, TX"
Montgomery,48339,143259,103769,3666,14975,20849,252207,165774,12921,42090,31422,0.051231726320046626,0.025590015286997676,0.02564171103304895,108948,0.7604967227189915,62005,0.5975291271959834,108948,2.5245499181669393,27115,1.8106844741235393,10573,0.5071226437718835,288,"Houston-The Woodlands, TX"
Navarro,48349,20051,13549,933,2407,3162,22402,13828,1361,3753,3460,0.060753504151415054,0.04653134507007132,0.014222159081343735,2351,0.11725100992469203,279,0.020591925603365563,2351,0.4587352625937835,1346,0.5592023265475696,298,0.09424414927261227,206,"Dallas-Fort Worth, TX-OK"
Palo Pinto,48363,12639,8397,591,1536,2115,12806,7792,1025,2106,1883,0.08004060596595346,0.04676002848326608,0.033280577482687375,167,0.013213070654323918,-605,-0.0720495415029177,167,0.7343485617597293,570,0.37109375,-232,-0.10969267139479906,206,"Dallas-Fort Worth, TX-OK"
Parker,48367,43493,30633,1493,5185,6182,61346,38866,3454,11264,7762,0.05630358947608646,0.03432736302393489,0.021976226452151575,17853,0.4104798473317545,8233,0.26876244572846275,17853,1.3134628265237775,6079,1.172420443587271,1580,0.25558071821417017,206,"Dallas-Fort Worth, TX-OK"
Rockwall,48397,21995,16321,525,2380,2769,45276,30540,2202,6901,5633,0.048635038430956797,0.023869061150261422,0.024765977280695375,23281,1.0584678335985451,14219,0.8712088720053919,23281,3.1942857142857144,4521,1.899579831932773,2864,1.0343084145901047,206,"Dallas-Fort Worth, TX-OK"
Somervell,48425,3269,2348,138,327,456,3807,2415,320,533,539,0.08405568689256633,0.04221474457020496,0.04184094232236137,538,0.16457632303456715,67,0.028534923339011926,538,1.318840579710145,206,0.6299694189602446,83,0.18201754385964913,206,"Dallas-Fort Worth, TX-OK"
Tarrant,48439,752129,543920,18415,66087,123707,1010529,680877,41407,142630,145615,0.04097556824198019,0.02448383189585829,0.0164917363461219,258400,0.34355808644527736,136957,0.2517962200323577,258400,1.2485473798533804,76543,1.1582156853844174,21908,0.17709587978044897,206,"Dallas-Fort Worth, TX-OK"
Trinity,48455,5379,3658,325,674,722,5348,3115,620,1037,576,0.11593118922961855,0.06042015244469232,0.05551103678492623,-31,-0.005763153002416806,-543,-0.1484417714598141,-31,0.9076923076923077,363,0.5385756676557863,-146,-0.20221606648199447,288,"Houston-The Woodlands, TX"
Walker,48471,24769,14745,555,1913,7556,23858,13223,1202,3209,6224,0.050381423421912985,0.022407041059388753,0.027974382362524232,-911,-0.036779845774960636,-1522,-0.10322143099355714,-911,1.1657657657657658,1296,0.6774699424986932,-1332,-0.17628374801482266,288,"Houston-The Woodlands, TX"
Waller,48473,15896,9621,563,1542,4170,22441,11803,1316,3165,6157,0.058642662982933025,0.03541771514846502,0.023224947834468004,6545,0.4117388022143936,2182,0.22679555139798357,6545,1.3374777975133214,1623,1.0525291828793775,1987,0.47649880095923264,288,"Houston-The Woodlands, TX"
Washington,48477,14127,9158,641,1518,2810,15429,9262,852,3039,2276,0.05522068831421349,0.04537410632122885,0.009846581992984639,1302,0.0921639413888299,104,0.011356191308145884,1302,0.3291731669266771,1521,1.0019762845849802,-534,-0.1900355871886121,288,"Houston-The Woodlands, TX"
Wharton,48481,18682,12777,881,2005,3019,19523,12027,1184,3580,2732,0.060646417046560465,0.04715769189594262,0.013488725150617845,841,0.0450165935124719,-750,-0.058699225170227756,841,0.3439273552780931,1575,0.7855361596009975,-287,-0.09506459092414707,288,"Houston-The Woodlands, TX"
Wise,48497,23700,16759,830,2665,3446,29012,18669,1436,5054,3853,0.049496759961395284,0.0350210970464135,0.014475662914981785,5312,0.22413502109704642,1910,0.11396861387910973,5312,0.7301204819277108,2389,0.8964352720450282,407,0.11810795124782357,206,"Dallas-Fort Worth, TX-OK"
Arlington,51013,120803,91696,2871,10223,16013,149956,113560,5805,16610,13981,0.03871135533089706,0.023765966077001398,0.014945389253895665,29153,0.24132678824201387,21864,0.23844006281626243,29153,1.0219435736677116,6387,0.6247676807199453,-2032,-0.1268968962717792,548,"Washington-Baltimore-Arlington, DC-MD-VA-WV-PA"
Clarke,51043,6712,4871,353,886,602,7394,4351,559,1652,832,0.07560183932918582,0.05259237187127533,0.023009467457910493,682,0.10160905840286055,-520,-0.10675425990556354,682,0.5835694050991501,766,0.8645598194130926,230,0.38205980066445183,548,"Washington-Baltimore-Arlington, DC-MD-VA-WV-PA"
Culpeper,51047,16832,12131,602,1734,2365,24411,15973,1244,4045,3149,0.050960632501741016,0.03576520912547528,0.015195423376265733,7579,0.45027328897338403,3842,0.31670925727475063,7579,1.0664451827242525,2311,1.3327566320645905,784,0.3315010570824524,548,"Washington-Baltimore-Arlington, DC-MD-VA-WV-PA"
Fairfax,51059,548812,412048,14662,62724,59378,646463,432455,34801,109276,69931,0.053832933980753735,0.02671588813655678,0.027117045844196955,97651,0.17793160499405988,20407,0.04952578340387528,97651,1.373550675214841,46552,0.7421720553536126,10553,0.17772575701438242,548,"Washington-Baltimore-Arlington, DC-MD-VA-WV-PA"
Fauquier,51061,29446,21304,940,3726,3476,36682,22912,2673,6487,4610,0.0728695272885884,0.03192284181213068,0.040946685476457724,7236,0.2457379610133804,1608,0.07547878332707472,7236,1.8436170212765957,2761,0.741009125067096,1134,0.32623705408515535,548,"Washington-Baltimore-Arlington, DC-MD-VA-WV-PA"
Frederick,51069,31787,22924,965,3583,4315,44363,28182,2405,8085,5691,0.05421184320266889,0.030358322584704438,0.023853520617964453,12576,0.39563343505206533,5258,0.22936660268714013,12576,1.4922279792746114,4502,1.2564889757186715,1376,0.31888760139049827,548,"Washington-Baltimore-Arlington, DC-MD-VA-WV-PA"
Loudoun,51107,95686,76182,1991,8054,9459,203298,147248,7725,26404,21921,0.03799840628043562,0.02080764166126706,0.017190764619168557,107612,1.1246368329745209,71066,0.9328450290094773,107612,2.8799598191863387,18350,2.278370995778495,12462,1.3174754202346972,548,"Washington-Baltimore-Arlington, DC-MD-VA-WV-PA"
Prince William,51153,157254,117961,2334,13505,23454,244658,170961,8158,33456,32083,0.033344505391199146,0.014842229768400168,0.018502275622798978,87404,0.5558141605300978,53000,0.4493010401742949,87404,2.49528706083976,19951,1.4773047019622363,8629,0.3679116568602371,548,"Washington-Baltimore-Arlington, DC-MD-VA-WV-PA"
Rappahannock,51157,3672,2600,192,544,336,3643,2039,413,813,378,0.11336810321163876,0.05228758169934641,0.06108052151229235,-29,-0.00789760348583878,-561,-0.21576923076923077,-29,1.1510416666666667,269,0.4944852941176471,42,0.125,548,"Washington-Baltimore-Arlington, DC-MD-VA-WV-PA"
Spotsylvania,51177,47747,35577,1210,4436,6524,67729,44738,2762,10507,9722,0.0407801680225605,0.02534190629777787,0.015438261724782631,19982,0.41849749722495655,9161,0.2574978216263316,19982,1.2826446280991735,6071,1.368575293056808,3198,0.4901900674432863,548,"Washington-Baltimore-Arlington, DC-MD-VA-WV-PA"
Stafford,51179,50424,38027,1000,4200,7197,73555,49524,2408,10656,10967,0.032737407382230986,0.019831826114548628,0.012905581267682358,23131,0.4587299698556243,11497,0.302337812606832,23131,1.408,6456,1.5371428571428571,3770,0.5238293733500069,548,"Washington-Baltimore-Arlington, DC-MD-VA-WV-PA"
Warren,51187,16257,11747,607,1616,2287,19931,12617,1089,3639,2586,0.054638502834779994,0.037337762194746875,0.01730074064003312,3674,0.22599495601894568,870,0.0740614625010641,3674,0.7940691927512356,2023,1.2518564356435644,299,0.13073895933537386,548,"Washington-Baltimore-Arlington, DC-MD-VA-WV-PA"
Alexandria,51510,80949,63050,1843,7039,9017,99345,75657,4429,12498,6761,0.044582012179777544,0.02276742146289639,0.021814590716881153,18396,0.2272541970870548,12607,0.1999524187153053,18396,1.4031470428648942,5459,0.7755362977695696,-2256,-0.25019407785294445,548,"Washington-Baltimore-Arlington, DC-MD-VA-WV-PA"
Fairfax,51600,12361,8882,456,1517,1506,13312,8650,675,2401,1586,0.050706129807692304,0.03689021923792574,0.013815910569766568,951,0.07693552301593722,-232,-0.026120243188471066,951,0.48026315789473684,884,0.5827290705339486,80,0.05312084993359894,548,"Washington-Baltimore-Arlington, DC-MD-VA-WV-PA"
Falls Church,51610,6072,4675,232,725,440,8180,5248,681,1482,769,0.0832518337408313,0.03820816864295125,0.04504366509788005,2108,0.347167325428195,573,0.1225668449197861,2108,1.9353448275862069,757,1.0441379310344827,329,0.7477272727272727,548,"Washington-Baltimore-Arlington, DC-MD-VA-WV-PA"
Fredericksburg,51630,10906,6144,492,905,3365,15145,9331,560,1843,3411,0.03697589963684384,0.045112781954887216,-0.008136882318043374,4239,0.3886851274527783,3187,0.5187174479166666,4239,0.13821138211382114,938,1.03646408839779,46,0.013670133729569094,548,"Washington-Baltimore-Arlington, DC-MD-VA-WV-PA"
Manassas,51683,19118,14301,361,1338,3118,23274,15760,860,3316,3338,0.036951104236487065,0.018882728318861806,0.018068375917625258,4156,0.21738675593681347,1459,0.10202083770365708,4156,1.3822714681440442,1978,1.4783258594917787,220,0.07055805003207184,548,"Washington-Baltimore-Arlington, DC-MD-VA-WV-PA"
Manassas Park,51685,5672,4388,107,310,867,8551,6468,217,1116,750,0.02537714887147702,0.01886459802538787,0.0065125508460891525,2879,0.5075811001410437,2080,0.4740200546946217,2879,1.02803738317757,806,2.6,-117,-0.13494809688581316,548,"Washington-Baltimore-Arlington, DC-MD-VA-WV-PA"
Winchester,51840,12777,8498,628,1226,2425,13562,8809,760,1909,2084,0.0560389323108686,0.0491508178758707,0.0068881144349978995,785,0.06143852234483838,311,0.03659684631678042,785,0.21019108280254778,683,0.5570962479608483,-341,-0.14061855670103093,548,"Washington-Baltimore-Arlington, DC-MD-VA-WV-PA"
Island,53029,34866,24309,961,3561,6035,39452,22372,2883,7602,6595,0.07307614316130995,0.027562668502265818,0.04551347465904413,4586,0.13153215166637985,-1937,-0.07968242214817557,4586,2.0,4041,1.134793597304128,560,0.0927920463960232,500,"Seattle-Tacoma, WA"
King,53033,974767,724781,23948,89103,136935,1175087,812194,49420,179496,133977,0.04205646050037146,0.0245679223855547,0.01748853811481676,200320,0.2055055208065107,87413,0.12060608652820645,200320,1.0636378820778354,90393,1.0144776270159255,-2958,-0.02160148975791434,500,"Seattle-Tacoma, WA"
Kitsap,53035,115055,83140,2324,10522,19069,129447,78146,6271,22766,22264,0.04844453714647694,0.020199035244013733,0.028245501902463204,14392,0.12508800139063925,-4994,-0.06006735626653837,14392,1.6983648881239242,12244,1.1636570994107585,3195,0.16754942576957366,500,"Seattle-Tacoma, WA"
Lewis,53041,29595,20624,772,3518,4681,32658,20560,1675,5908,4515,0.05128911752097495,0.02608548741341443,0.025203630107560524,3063,0.10349721236695388,-64,-0.0031031807602792862,3063,1.1696891191709844,2390,0.679363274587834,-166,-0.035462508011108736,500,"Seattle-Tacoma, WA"
Mason,53045,21217,14876,726,2564,3051,25354,15800,1496,4946,3112,0.059004496331939736,0.03421784418155253,0.02478665215038721,4137,0.19498515341471462,924,0.062113471363269696,4137,1.0606060606060606,2382,0.9290171606864275,61,0.019993444772205833,500,"Seattle-Tacoma, WA"
Pierce,53053,352677,254020,8029,31285,59343,422116,275930,17118,65335,63733,0.040552833818192156,0.022765873589715234,0.017786960228476922,69439,0.19689120640132474,21910,0.0862530509408708,69439,1.132021422344003,34050,1.088381013265143,4390,0.0739767116593364,500,"Seattle-Tacoma, WA"
Skagit,53057,49692,34532,1526,5371,8263,57087,34709,3323,11020,8035,0.05820939968819521,0.03070916847782339,0.02750023121037182,7395,0.14881671093938661,177,0.005125680528205722,7395,1.1775884665792922,5649,1.0517594488921989,-228,-0.02759288394045746,500,"Seattle-Tacoma, WA"
Snohomish,53061,322533,238216,7212,28496,48609,407615,269086,16304,69552,52673,0.03999852802276658,0.02236050264624085,0.01763802537652573,85082,0.26379316225006433,30870,0.12958827282802163,85082,1.2606766500277315,41056,1.4407636159460977,4064,0.08360591659980662,500,"Seattle-Tacoma, WA"
Thurston,53067,108808,78118,2397,11236,17057,134760,86883,5795,23927,18155,0.043002374591867024,0.022029630174251892,0.02097274441761513,25952,0.23851187412690245,8765,0.11220205330397603,25952,1.4176053400083437,12691,1.1294944820220718,1098,0.06437239842879756,500,"Seattle-Tacoma, WA"
Berkeley,54003,38040,27631,1003,3564,5842,56004,37335,2533,8663,7473,0.045228912220555674,0.026366982124079917,0.018861930096475757,17964,0.4722397476340694,9704,0.3511997394231117,17964,1.5254237288135593,5099,1.430695847362514,1631,0.27918521054433415,548,"Washington-Baltimore-Arlington, DC-MD-VA-WV-PA"
Hampshire,54027,9056,6431,350,1063,1212,9700,6402,440,1813,1045,0.04536082474226804,0.03864840989399293,0.00671241484827511,644,0.071113074204947,-29,-0.004509407557145078,644,0.2571428571428571,750,0.7055503292568204,-167,-0.1377887788778878,548,"Washington-Baltimore-Arlington, DC-MD-VA-WV-PA"
Jefferson,54037,22669,15828,737,2454,3650,29404,18728,1738,5268,3670,0.059107604407563595,0.032511359124795976,0.02659624528276762,6735,0.29710176893555074,2900,0.18321961081627497,6735,1.3582089552238805,2814,1.1466992665036675,20,0.005479452054794521,548,"Washington-Baltimore-Arlington, DC-MD-VA-WV-PA"
Kenosha,55059,77980,55476,1895,7099,13510,88879,58245,2995,13362,14277,0.0336974988467467,0.024301102846883818,0.009396395999862882,10899,0.1397666068222621,2769,0.04991347609777201,10899,0.5804749340369393,6263,0.8822369347795465,767,0.05677276091783864,176,"Chicago-Naperville, IL-IN-WI"
Pierce,55093,22165,13868,621,1839,5837,23604,13421,1000,3881,5302,0.04236570072869005,0.028017144146176405,0.014348556582513647,1439,0.06492217459959396,-447,-0.03223247764638015,1439,0.6103059581320451,2042,1.1103860793909734,-535,-0.09165667294843241,378,"Minneapolis-St. Paul, MN-WI"
St. Croix,55109,35867,26097,1024,3228,5518,48805,32472,1851,8192,6290,0.037926441962913636,0.028549920539771935,0.009376521423141701,12938,0.3607215546323919,6375,0.2442809518335441,12938,0.8076171875,4964,1.5377942998760843,772,0.13990576295759333,378,"Minneapolis-St. Paul, MN-WI"
