County_name,2000,STCO,CSA,CSA_Name,2010,2000-2010_NET,2000-2010_%
Alameda,1443741,06001,488,"San Jose-San Francisco-Oakland, CA",1510271,66530,0.04608167254375958
Contra Costa,948816,06013,488,"San Jose-San Francisco-Oakland, CA",1049025,100209,0.10561478727171549
Los Angeles,9519338,06037,348,"Los Angeles-Long Beach, CA",9818605,299267,0.031437795359299144
Marin,247289,06041,488,"San Jose-San Francisco-Oakland, CA",252409,5120,0.020704519812850552
Napa,124279,06055,488,"San Jose-San Francisco-Oakland, CA",136484,12205,0.09820645483146791
Orange,2846289,06059,348,"Los Angeles-Long Beach, CA",3010232,163943,0.057598859427134774
Riverside,1545387,06065,348,"Los Angeles-Long Beach, CA",2189641,644254,0.4168884557719199
San Benito,53234,06069,488,"San Jose-San Francisco-Oakland, CA",55269,2035,0.03822744862306045
San Bernardino,1709434,06071,348,"Los Angeles-Long Beach, CA",2035210,325776,0.190575360031449
San Francisco,776733,06075,488,"San Jose-San Francisco-Oakland, CA",805235,28502,0.03669472006468117
San Joaquin,563598,06077,488,"San Jose-San Francisco-Oakland, CA",685306,121708,0.21594824680002414
San Mateo,707161,06081,488,"San Jose-San Francisco-Oakland, CA",718451,11290,0.015965246952249913
Santa Clara,1682585,06085,488,"San Jose-San Francisco-Oakland, CA",1781642,99057,0.058871914346080585
Santa Cruz,255602,06087,488,"San Jose-San Francisco-Oakland, CA",262382,6780,0.026525614040578713
Solano,394542,06095,488,"San Jose-San Francisco-Oakland, CA",413344,18802,0.04765525596767898
Sonoma,458614,06097,488,"San Jose-San Francisco-Oakland, CA",483878,25264,0.05508772082840908
Ventura,753197,06111,348,"Los Angeles-Long Beach, CA",823318,70121,0.0930978216854289
Adams,363857,08001,216,"Denver-Aurora, CO",441603,77746,0.2136718546022201
Arapahoe,487967,08005,216,"Denver-Aurora, CO",572003,84036,0.17221656382501277
Boulder,291288,08013,216,"Denver-Aurora, CO",294567,3279,0.011256900387245613
Clear Creek,9322,08019,216,"Denver-Aurora, CO",9088,-234,-0.02510190946148895
Denver,554636,08031,216,"Denver-Aurora, CO",600158,45522,0.08207545128697019
Douglas,175766,08035,216,"Denver-Aurora, CO",285465,109699,0.6241195680620826
Elbert,19872,08039,216,"Denver-Aurora, CO",23086,3214,0.16173510466988728
Gilpin,4757,08047,216,"Denver-Aurora, CO",5441,684,0.14378810174479714
Jefferson,527056,08059,216,"Denver-Aurora, CO",534543,7487,0.01420532163565162
Park,14523,08093,216,"Denver-Aurora, CO",16206,1683,0.11588514769675687
Weld,180936,08123,216,"Denver-Aurora, CO",252825,71889,0.39731728345934475
Fairfield,882567,09001,408,"New York-Newark, NY-NJ-CT-PA",916829,34262,0.03882084872876507
Litchfield,182193,09005,408,"New York-Newark, NY-NJ-CT-PA",189927,7734,0.04244949037559072
New Haven,824008,09009,408,"New York-Newark, NY-NJ-CT-PA",862477,38469,0.04668522635702566
Windham,109091,09015,148,"Boston-Worcester-Providence, MA-RI-NH-CT",118428,9337,0.08558909534242055
Kent,126697,10001,428,"Philadelphia-Reading-Camden, PA-NJ-DE-MD",162310,35613,0.28108794999092324
New Castle,500265,10003,428,"Philadelphia-Reading-Camden, PA-NJ-DE-MD",538479,38214,0.07638751461725285
District of Columbia,572059,11001,548,"Washington-Baltimore-Arlington, DC-MD-VA-WV-PA",601723,29664,0.051854791201606826
Broward,1623018,12011,370,"Miami-Fort Lauderdale-Port St. Lucie, FL",1748066,125048,0.07704658851596224
Indian River,112947,12061,370,"Miami-Fort Lauderdale-Port St. Lucie, FL",138028,25081,0.2220599042028562
Martin,126731,12085,370,"Miami-Fort Lauderdale-Port St. Lucie, FL",146318,19587,0.1545557124933915
Miami-Dade,2253362,12086,370,"Miami-Fort Lauderdale-Port St. Lucie, FL",2496435,243073,0.1078712608094039
Okeechobee,35910,12093,370,"Miami-Fort Lauderdale-Port St. Lucie, FL",39996,4086,0.11378446115288221
Palm Beach,1131184,12099,370,"Miami-Fort Lauderdale-Port St. Lucie, FL",1320134,188950,0.16703736969405508
St. Lucie,192695,12111,370,"Miami-Fort Lauderdale-Port St. Lucie, FL",277789,85094,0.441599418770596
Barrow,46144,13013,122,"Atlanta--Athens-Clarke County--Sandy Springs, GA",69367,23223,0.5032723647711512
Bartow,76019,13015,122,"Atlanta--Athens-Clarke County--Sandy Springs, GA",100157,24138,0.31752588168747287
Butts,19522,13035,122,"Atlanta--Athens-Clarke County--Sandy Springs, GA",23655,4133,0.2117098657924393
Carroll,87268,13045,122,"Atlanta--Athens-Clarke County--Sandy Springs, GA",110527,23259,0.26652381170646744
Cherokee,141903,13057,122,"Atlanta--Athens-Clarke County--Sandy Springs, GA",214346,72443,0.5105107009717906
Clarke,101489,13059,122,"Atlanta--Athens-Clarke County--Sandy Springs, GA",116714,15225,0.15001625791957748
Clayton,236517,13063,122,"Atlanta--Athens-Clarke County--Sandy Springs, GA",259424,22907,0.09685138911790696
Cobb,607751,13067,122,"Atlanta--Athens-Clarke County--Sandy Springs, GA",688078,80327,0.13217090551887203
Coweta,89215,13077,122,"Atlanta--Athens-Clarke County--Sandy Springs, GA",127317,38102,0.4270806478731155
Dawson,15999,13085,122,"Atlanta--Athens-Clarke County--Sandy Springs, GA",22330,6331,0.3957122320145009
DeKalb,665865,13089,122,"Atlanta--Athens-Clarke County--Sandy Springs, GA",691893,26028,0.03908900452794485
Douglas,92174,13097,122,"Atlanta--Athens-Clarke County--Sandy Springs, GA",132403,40229,0.43644628637142796
Fayette,91263,13113,122,"Atlanta--Athens-Clarke County--Sandy Springs, GA",106567,15304,0.16769117824309962
Forsyth,98407,13117,122,"Atlanta--Athens-Clarke County--Sandy Springs, GA",175511,77104,0.7835214974544494
Fulton,816006,13121,122,"Atlanta--Athens-Clarke County--Sandy Springs, GA",920581,104575,0.12815469494096857
Gordon,44104,13129,122,"Atlanta--Athens-Clarke County--Sandy Springs, GA",55186,11082,0.25126972610194087
Gwinnett,588448,13135,122,"Atlanta--Athens-Clarke County--Sandy Springs, GA",805321,216873,0.3685508320191419
Hall,139277,13139,122,"Atlanta--Athens-Clarke County--Sandy Springs, GA",179684,40407,0.2901196895395507
Haralson,25690,13143,122,"Atlanta--Athens-Clarke County--Sandy Springs, GA",28780,3090,0.12028026469443363
Heard,11012,13149,122,"Atlanta--Athens-Clarke County--Sandy Springs, GA",11834,822,0.07464584090083545
Henry,119341,13151,122,"Atlanta--Athens-Clarke County--Sandy Springs, GA",203922,84581,0.7087337964320728
Jackson,41589,13157,122,"Atlanta--Athens-Clarke County--Sandy Springs, GA",60485,18896,0.4543509100964197
Jasper,11426,13159,122,"Atlanta--Athens-Clarke County--Sandy Springs, GA",13900,2474,0.21652371783651322
Lamar,15912,13171,122,"Atlanta--Athens-Clarke County--Sandy Springs, GA",18317,2405,0.1511437908496732
Madison,25730,13195,122,"Atlanta--Athens-Clarke County--Sandy Springs, GA",28120,2390,0.09288767975126312
Meriwether,22534,13199,122,"Atlanta--Athens-Clarke County--Sandy Springs, GA",21992,-542,-0.0240525428241768
Morgan,15457,13211,122,"Atlanta--Athens-Clarke County--Sandy Springs, GA",17868,2411,0.15598110888270686
Newton,62001,13217,122,"Atlanta--Athens-Clarke County--Sandy Springs, GA",99958,37957,0.6121998032289802
Oconee,26225,13219,122,"Atlanta--Athens-Clarke County--Sandy Springs, GA",32808,6583,0.2510200190657769
Oglethorpe,12635,13221,122,"Atlanta--Athens-Clarke County--Sandy Springs, GA",14899,2264,0.17918480411555204
Paulding,81678,13223,122,"Atlanta--Athens-Clarke County--Sandy Springs, GA",142324,60646,0.7425010406719068
Pickens,22983,13227,122,"Atlanta--Athens-Clarke County--Sandy Springs, GA",29431,6448,0.280555192968716
Pike,13688,13231,122,"Atlanta--Athens-Clarke County--Sandy Springs, GA",17869,4181,0.3054500292226768
Polk,38127,13233,122,"Atlanta--Athens-Clarke County--Sandy Springs, GA",41475,3348,0.08781178692265323
Rockdale,70111,13247,122,"Atlanta--Athens-Clarke County--Sandy Springs, GA",85215,15104,0.21542981843077405
Spalding,58417,13255,122,"Atlanta--Athens-Clarke County--Sandy Springs, GA",64073,5656,0.09682113083520208
Troup,58779,13285,122,"Atlanta--Athens-Clarke County--Sandy Springs, GA",67044,8265,0.14061144286224672
Upson,27597,13293,122,"Atlanta--Athens-Clarke County--Sandy Springs, GA",27153,-444,-0.0160887052940537
Walton,60687,13297,122,"Atlanta--Athens-Clarke County--Sandy Springs, GA",83768,23081,0.38032857119317154
Bureau,35503,17011,176,"Chicago-Naperville, IL-IN-WI",34978,-525,-0.014787482747936793
Cook,5376741,17031,176,"Chicago-Naperville, IL-IN-WI",5194675,-182066,-0.03386177612051613
DeKalb,88969,17037,176,"Chicago-Naperville, IL-IN-WI",105160,16191,0.18198473625644887
DuPage,904161,17043,176,"Chicago-Naperville, IL-IN-WI",916924,12763,0.014115848836656304
Grundy,37535,17063,176,"Chicago-Naperville, IL-IN-WI",50063,12528,0.3337684827494339
Kane,404119,17089,176,"Chicago-Naperville, IL-IN-WI",515269,111150,0.2750427473095796
Kankakee,103833,17091,176,"Chicago-Naperville, IL-IN-WI",113449,9616,0.09261024915007753
Kendall,54544,17093,176,"Chicago-Naperville, IL-IN-WI",114736,60192,1.1035494279847462
Lake,644356,17097,176,"Chicago-Naperville, IL-IN-WI",703462,59106,0.09172879588302119
LaSalle,111509,17099,176,"Chicago-Naperville, IL-IN-WI",113924,2415,0.021657444690563094
McHenry,260077,17111,176,"Chicago-Naperville, IL-IN-WI",308760,48683,0.18718687158033967
Putnam,6086,17155,176,"Chicago-Naperville, IL-IN-WI",6006,-80,-0.013144922773578704
Will,502266,17197,176,"Chicago-Naperville, IL-IN-WI",677560,175294,0.34900630343284234
Jasper,30043,18073,176,"Chicago-Naperville, IL-IN-WI",33478,3435,0.11433611823053623
Lake,484564,18089,176,"Chicago-Naperville, IL-IN-WI",496005,11441,0.02361091620508333
LaPorte,110106,18091,176,"Chicago-Naperville, IL-IN-WI",111467,1361,0.012360815941002306
Newton,14566,18111,176,"Chicago-Naperville, IL-IN-WI",14244,-322,-0.022106274886722503
Porter,146798,18127,176,"Chicago-Naperville, IL-IN-WI",164343,17545,0.11951797708415646
Anne Arundel,489656,24003,548,"Washington-Baltimore-Arlington, DC-MD-VA-WV-PA",537656,48000,0.09802800333295211
Baltimore,754292,24005,548,"Washington-Baltimore-Arlington, DC-MD-VA-WV-PA",805029,50737,0.06726440158453224
Calvert,74563,24009,548,"Washington-Baltimore-Arlington, DC-MD-VA-WV-PA",88737,14174,0.19009428268712364
Carroll,150897,24013,548,"Washington-Baltimore-Arlington, DC-MD-VA-WV-PA",167134,16237,0.1076031995334566
Cecil,85951,24015,428,"Philadelphia-Reading-Camden, PA-NJ-DE-MD",101108,15157,0.17634466149317635
Charles,120546,24017,548,"Washington-Baltimore-Arlington, DC-MD-VA-WV-PA",146551,26005,0.21572677650025715
Dorchester,30674,24019,548,"Washington-Baltimore-Arlington, DC-MD-VA-WV-PA",32618,1944,0.06337614918171741
Frederick,195277,24021,548,"Washington-Baltimore-Arlington, DC-MD-VA-WV-PA",233385,38108,0.19514843017866929
Harford,218590,24025,548,"Washington-Baltimore-Arlington, DC-MD-VA-WV-PA",244826,26236,0.1200237888284002
Howard,247842,24027,548,"Washington-Baltimore-Arlington, DC-MD-VA-WV-PA",287085,39243,0.15833878035199844
Montgomery,873341,24031,548,"Washington-Baltimore-Arlington, DC-MD-VA-WV-PA",971777,98436,0.11271198764285657
Prince George's,801515,24033,548,"Washington-Baltimore-Arlington, DC-MD-VA-WV-PA",863420,61905,0.07723498624479891
Queen Anne's,40563,24035,548,"Washington-Baltimore-Arlington, DC-MD-VA-WV-PA",47798,7235,0.1783645193895915
St. Mary's,86211,24037,548,"Washington-Baltimore-Arlington, DC-MD-VA-WV-PA",105151,18940,0.21969354258737284
Talbot,33812,24041,548,"Washington-Baltimore-Arlington, DC-MD-VA-WV-PA",37782,3970,0.1174139358807524
Washington,131923,24043,548,"Washington-Baltimore-Arlington, DC-MD-VA-WV-PA",147430,15507,0.11754584113460124
Baltimore,651154,24510,548,"Washington-Baltimore-Arlington, DC-MD-VA-WV-PA",620961,-30193,-0.04636844740261136
Barnstable,222230,25001,148,"Boston-Worcester-Providence, MA-RI-NH-CT",215888,-6342,-0.02853800116995905
Bristol,534678,25005,148,"Boston-Worcester-Providence, MA-RI-NH-CT",548285,13607,0.02544896180504902
Essex,723419,25009,148,"Boston-Worcester-Providence, MA-RI-NH-CT",743159,19740,0.0272870908837064
Middlesex,1465396,25017,148,"Boston-Worcester-Providence, MA-RI-NH-CT",1503085,37689,0.025719327744855316
Norfolk,650308,25021,148,"Boston-Worcester-Providence, MA-RI-NH-CT",670850,20542,0.031588109019110945
Plymouth,472822,25023,148,"Boston-Worcester-Providence, MA-RI-NH-CT",494919,22097,0.04673428901362458
Suffolk,689807,25025,148,"Boston-Worcester-Providence, MA-RI-NH-CT",722023,32216,0.04670291835252469
Worcester,750963,25027,148,"Boston-Worcester-Providence, MA-RI-NH-CT",798552,47589,0.06337063210837285
Genesee,436141,26049,220,"Detroit-Warren-Ann Arbor, MI",425790,-10351,-0.023733150517837122
Lapeer,87904,26087,220,"Detroit-Warren-Ann Arbor, MI",88319,415,0.0047210593374590465
Lenawee,98890,26091,220,"Detroit-Warren-Ann Arbor, MI",99892,1002,0.010132470421680655
Livingston,156951,26093,220,"Detroit-Warren-Ann Arbor, MI",180967,24016,0.15301590942396034
Macomb,788149,26099,220,"Detroit-Warren-Ann Arbor, MI",840978,52829,0.0670292038688116
Monroe,145945,26115,220,"Detroit-Warren-Ann Arbor, MI",152021,6076,0.04163212168967762
Oakland,1194156,26125,220,"Detroit-Warren-Ann Arbor, MI",1202362,8206,0.0068717989944362375
St. Clair,164235,26147,220,"Detroit-Warren-Ann Arbor, MI",163040,-1195,-0.00727615916217615
Washtenaw,322895,26161,220,"Detroit-Warren-Ann Arbor, MI",344791,21896,0.06781151767602471
Wayne,2061162,26163,220,"Detroit-Warren-Ann Arbor, MI",1820584,-240578,-0.11671959797434651
Anoka,298084,27003,378,"Minneapolis-St. Paul, MN-WI",330844,32760,0.10990190684505038
Benton,34226,27009,378,"Minneapolis-St. Paul, MN-WI",38451,4225,0.1234441652544849
Carver,70205,27019,378,"Minneapolis-St. Paul, MN-WI",91042,20837,0.29680222206395557
Chisago,41101,27025,378,"Minneapolis-St. Paul, MN-WI",53887,12786,0.3110873214763631
Dakota,355904,27037,378,"Minneapolis-St. Paul, MN-WI",398552,42648,0.1198300665347959
Goodhue,44127,27049,378,"Minneapolis-St. Paul, MN-WI",46183,2056,0.04659278899539964
Hennepin,1116200,27053,378,"Minneapolis-St. Paul, MN-WI",1152425,36225,0.03245386131517649
Isanti,31287,27059,378,"Minneapolis-St. Paul, MN-WI",37816,6529,0.20868092178860229
Le Sueur,25426,27079,378,"Minneapolis-St. Paul, MN-WI",27703,2277,0.08955399984268073
McLeod,34898,27085,378,"Minneapolis-St. Paul, MN-WI",36651,1753,0.05023210499169007
Mille Lacs,22330,27095,378,"Minneapolis-St. Paul, MN-WI",26097,3767,0.16869682042095835
Ramsey,511035,27123,378,"Minneapolis-St. Paul, MN-WI",508640,-2395,-0.0046865674562407665
Rice,56665,27131,378,"Minneapolis-St. Paul, MN-WI",64142,7477,0.13195093973352157
Scott,89498,27139,378,"Minneapolis-St. Paul, MN-WI",129928,40430,0.45174193836733784
Sherburne,64417,27141,378,"Minneapolis-St. Paul, MN-WI",88499,24082,0.37384541347780864
Sibley,15356,27143,378,"Minneapolis-St. Paul, MN-WI",15226,-130,-0.008465746288095858
Stearns,133166,27145,378,"Minneapolis-St. Paul, MN-WI",150642,17476,0.13123469954793265
Washington,201130,27163,378,"Minneapolis-St. Paul, MN-WI",238136,37006,0.18399045393526575
Wright,89986,27171,378,"Minneapolis-St. Paul, MN-WI",124700,34714,0.38577111995199254
Belknap,56325,33001,148,"Boston-Worcester-Providence, MA-RI-NH-CT",60088,3763,0.06680869951176209
Hillsborough,380841,33011,148,"Boston-Worcester-Providence, MA-RI-NH-CT",400721,19880,0.05220026205161734
Merrimack,136225,33013,148,"Boston-Worcester-Providence, MA-RI-NH-CT",146445,10220,0.0750229399889888
Rockingham,277359,33015,148,"Boston-Worcester-Providence, MA-RI-NH-CT",295223,17864,0.06440750074812787
Strafford,112233,33017,148,"Boston-Worcester-Providence, MA-RI-NH-CT",123143,10910,0.09720848591768909
Atlantic,252552,34001,428,"Philadelphia-Reading-Camden, PA-NJ-DE-MD",274549,21997,0.08709889448509614
Bergen,884118,34003,408,"New York-Newark, NY-NJ-CT-PA",905116,20998,0.023750223386471037
Burlington,423394,34005,428,"Philadelphia-Reading-Camden, PA-NJ-DE-MD",448734,25340,0.05984969083170758
Camden,508932,34007,428,"Philadelphia-Reading-Camden, PA-NJ-DE-MD",513657,4725,0.009284147980476764
Cape May,102326,34009,428,"Philadelphia-Reading-Camden, PA-NJ-DE-MD",97265,-5061,-0.049459570392666574
Cumberland,146438,34011,428,"Philadelphia-Reading-Camden, PA-NJ-DE-MD",156898,10460,0.07142954697551182
Essex,793633,34013,408,"New York-Newark, NY-NJ-CT-PA",783969,-9664,-0.012176913006389603
Gloucester,254673,34015,428,"Philadelphia-Reading-Camden, PA-NJ-DE-MD",288288,33615,0.13199279075520373
Hudson,608975,34017,408,"New York-Newark, NY-NJ-CT-PA",634266,25291,0.041530440494273166
Hunterdon,121989,34019,408,"New York-Newark, NY-NJ-CT-PA",128349,6360,0.05213584831419226
Mercer,350761,34021,408,"New York-Newark, NY-NJ-CT-PA",366513,15752,0.04490807130781358
Middlesex,750162,34023,408,"New York-Newark, NY-NJ-CT-PA",809858,59696,0.07957747793143348
Monmouth,615301,34025,408,"New York-Newark, NY-NJ-CT-PA",630380,15079,0.024506704848521292
Morris,470212,34027,408,"New York-Newark, NY-NJ-CT-PA",492276,22064,0.04692351535052274
Ocean,510916,34029,408,"New York-Newark, NY-NJ-CT-PA",576567,65651,0.12849666089924763
Passaic,489049,34031,408,"New York-Newark, NY-NJ-CT-PA",501226,12177,0.02489934546436042
Salem,64285,34033,428,"Philadelphia-Reading-Camden, PA-NJ-DE-MD",66083,1798,0.027969199657773974
Somerset,297490,34035,408,"New York-Newark, NY-NJ-CT-PA",323444,25954,0.08724326868130021
Sussex,144166,34037,408,"New York-Newark, NY-NJ-CT-PA",149265,5099,0.035368949683004317
Union,522541,34039,408,"New York-Newark, NY-NJ-CT-PA",536499,13958,0.02671177955414025
Warren,102437,34041,408,"New York-Newark, NY-NJ-CT-PA",108692,6255,0.06106192098558138
Bronx,1332650,36005,408,"New York-Newark, NY-NJ-CT-PA",1385108,52458,0.03936367388286497
Dutchess,280150,36027,408,"New York-Newark, NY-NJ-CT-PA",297488,17338,0.061888274138854185
Kings,2465326,36047,408,"New York-Newark, NY-NJ-CT-PA",2504700,39374,0.0159711129481456
Nassau,1334544,36059,408,"New York-Newark, NY-NJ-CT-PA",1339532,4988,0.003737606253521802
New York,1537195,36061,408,"New York-Newark, NY-NJ-CT-PA",1585873,48678,0.031666769668129285
Orange,341367,36071,408,"New York-Newark, NY-NJ-CT-PA",372813,31446,0.0921178672806686
Putnam,95745,36079,408,"New York-Newark, NY-NJ-CT-PA",99710,3965,0.041412084181941616
Queens,2229379,36081,408,"New York-Newark, NY-NJ-CT-PA",2230722,1343,0.0006024099087683162
Richmond,443728,36085,408,"New York-Newark, NY-NJ-CT-PA",468730,25002,0.056345328669815745
Rockland,286753,36087,408,"New York-Newark, NY-NJ-CT-PA",311687,24934,0.08695288279460023
Suffolk,1419369,36103,408,"New York-Newark, NY-NJ-CT-PA",1493350,73981,0.05212245723275625
Sullivan,73966,36105,408,"New York-Newark, NY-NJ-CT-PA",77547,3581,0.048414136224751915
Ulster,177749,36111,408,"New York-Newark, NY-NJ-CT-PA",182493,4744,0.026689320333729023
Westchester,923459,36119,408,"New York-Newark, NY-NJ-CT-PA",949113,25654,0.02778033458984102
Bryan,36534,40013,206,"Dallas-Fort Worth, TX-OK",42416,5882,0.1610007116658455
Berks,373638,42011,428,"Philadelphia-Reading-Camden, PA-NJ-DE-MD",411442,37804,0.10117814569181935
Bucks,597635,42017,428,"Philadelphia-Reading-Camden, PA-NJ-DE-MD",625249,27614,0.04620545985425887
Chester,433501,42029,428,"Philadelphia-Reading-Camden, PA-NJ-DE-MD",498886,65385,0.15083010189134513
Delaware,550864,42045,428,"Philadelphia-Reading-Camden, PA-NJ-DE-MD",558979,8115,0.014731403758459438
Franklin,129313,42055,548,"Washington-Baltimore-Arlington, DC-MD-VA-WV-PA",149618,20305,0.15702210914602555
Montgomery,750097,42091,428,"Philadelphia-Reading-Camden, PA-NJ-DE-MD",799874,49777,0.06636075067624587
Philadelphia,1517550,42101,428,"Philadelphia-Reading-Camden, PA-NJ-DE-MD",1526006,8456,0.005572139303482587
Bristol,50648,44001,148,"Boston-Worcester-Providence, MA-RI-NH-CT",49875,-773,-0.015262201863844574
Kent,167090,44003,148,"Boston-Worcester-Providence, MA-RI-NH-CT",166158,-932,-0.005577832305942905
Newport,85433,44005,148,"Boston-Worcester-Providence, MA-RI-NH-CT",82888,-2545,-0.02978942563178163
Providence,621602,44007,148,"Boston-Worcester-Providence, MA-RI-NH-CT",626667,5065,0.00814830068114324
Washington,123546,44009,148,"Boston-Worcester-Providence, MA-RI-NH-CT",126979,3433,0.02778722095413854
Austin,23590,48015,288,"Houston-The Woodlands, TX",28417,4827,0.2046206019499788
Brazoria,241767,48039,288,"Houston-The Woodlands, TX",313166,71399,0.2953215285791692
Chambers,26031,48071,288,"Houston-The Woodlands, TX",35096,9065,0.34823863854634857
Collin,491675,48085,206,"Dallas-Fort Worth, TX-OK",782341,290666,0.5911750648294096
Cooke,36363,48097,206,"Dallas-Fort Worth, TX-OK",38437,2074,0.05703599812996728
Dallas,2218899,48113,206,"Dallas-Fort Worth, TX-OK",2368139,149240,0.06725858184622194
Denton,432976,48121,206,"Dallas-Fort Worth, TX-OK",662614,229638,0.5303711984036067
Ellis,111360,48139,206,"Dallas-Fort Worth, TX-OK",149610,38250,0.34348060344827586
Fort Bend,354452,48157,288,"Houston-The Woodlands, TX",585375,230923,0.6514930089264555
Galveston,250158,48167,288,"Houston-The Woodlands, TX",291309,41151,0.16450003597726237
Grayson,110595,48181,206,"Dallas-Fort Worth, TX-OK",120877,10282,0.09296984492969845
Harris,3400578,48201,288,"Houston-The Woodlands, TX",4092459,691881,0.20345982359469478
Henderson,73277,48213,206,"Dallas-Fort Worth, TX-OK",78532,5255,0.07171418043860966
Hood,41100,48221,206,"Dallas-Fort Worth, TX-OK",51182,10082,0.24530413625304137
Hopkins,31960,48223,206,"Dallas-Fort Worth, TX-OK",35161,3201,0.10015644555694618
Hunt,76596,48231,206,"Dallas-Fort Worth, TX-OK",86129,9533,0.12445819625045694
Johnson,126811,48251,206,"Dallas-Fort Worth, TX-OK",150934,24123,0.1902279770682354
Kaufman,71313,48257,206,"Dallas-Fort Worth, TX-OK",103350,32037,0.44924487821294856
Liberty,70154,48291,288,"Houston-The Woodlands, TX",75643,5489,0.0782421529777347
Matagorda,37957,48321,288,"Houston-The Woodlands, TX",36702,-1255,-0.03306373001027479
Montgomery,293768,48339,288,"Houston-The Woodlands, TX",455746,161978,0.5513806813539937
Navarro,45124,48349,206,"Dallas-Fort Worth, TX-OK",47735,2611,0.05786277812250687
Palo Pinto,27026,48363,206,"Dallas-Fort Worth, TX-OK",28111,1085,0.04014652556797158
Parker,88495,48367,206,"Dallas-Fort Worth, TX-OK",116927,28432,0.32128368834397425
Rockwall,43080,48397,206,"Dallas-Fort Worth, TX-OK",78337,35257,0.8184076137418755
Somervell,6809,48425,206,"Dallas-Fort Worth, TX-OK",8490,1681,0.24687913056249083
Tarrant,1446219,48439,206,"Dallas-Fort Worth, TX-OK",1809034,362815,0.25087141020827414
Trinity,13779,48455,288,"Houston-The Woodlands, TX",14585,806,0.058494810944190435
Walker,61758,48471,288,"Houston-The Woodlands, TX",67861,6103,0.09882120534991418
Waller,32663,48473,288,"Houston-The Woodlands, TX",43205,10542,0.32275051281266265
Washington,30373,48477,288,"Houston-The Woodlands, TX",33718,3345,0.11013070819477826
Wharton,41188,48481,288,"Houston-The Woodlands, TX",41280,92,0.002233660289404681
Wise,48793,48497,206,"Dallas-Fort Worth, TX-OK",59127,10334,0.21179267517881664
Arlington,189453,51013,548,"Washington-Baltimore-Arlington, DC-MD-VA-WV-PA",207627,18174,0.09592880556127377
Clarke,12652,51043,548,"Washington-Baltimore-Arlington, DC-MD-VA-WV-PA",14034,1382,0.1092317420170724
Culpeper,34262,51047,548,"Washington-Baltimore-Arlington, DC-MD-VA-WV-PA",46689,12427,0.36270503765104195
Fairfax,969749,51059,548,"Washington-Baltimore-Arlington, DC-MD-VA-WV-PA",1081726,111977,0.11547008555822176
Fauquier,55139,51061,548,"Washington-Baltimore-Arlington, DC-MD-VA-WV-PA",65203,10064,0.18252053900143275
Frederick,59209,51069,548,"Washington-Baltimore-Arlington, DC-MD-VA-WV-PA",78305,19096,0.3225185360333733
Loudoun,169599,51107,548,"Washington-Baltimore-Arlington, DC-MD-VA-WV-PA",312311,142712,0.8414672256322266
Prince William,280813,51153,548,"Washington-Baltimore-Arlington, DC-MD-VA-WV-PA",402002,121189,0.43156477798392523
Rappahannock,6983,51157,548,"Washington-Baltimore-Arlington, DC-MD-VA-WV-PA",7373,390,0.055849921237290566
Spotsylvania,90395,51177,548,"Washington-Baltimore-Arlington, DC-MD-VA-WV-PA",122397,32002,0.35402400575253057
Stafford,92446,51179,548,"Washington-Baltimore-Arlington, DC-MD-VA-WV-PA",128961,36515,0.39498734396296215
Warren,31584,51187,548,"Washington-Baltimore-Arlington, DC-MD-VA-WV-PA",37575,5991,0.18968465045592706
Alexandria,128283,51510,548,"Washington-Baltimore-Arlington, DC-MD-VA-WV-PA",139966,11683,0.09107208281689702
Fairfax,21498,51600,548,"Washington-Baltimore-Arlington, DC-MD-VA-WV-PA",22565,1067,0.04963252395571681
Falls Church,10377,51610,548,"Washington-Baltimore-Arlington, DC-MD-VA-WV-PA",12332,1955,0.18839741736532717
Fredericksburg,19279,51630,548,"Washington-Baltimore-Arlington, DC-MD-VA-WV-PA",24286,5007,0.25971264069713157
Manassas,35135,51683,548,"Washington-Baltimore-Arlington, DC-MD-VA-WV-PA",37821,2686,0.07644798633840899
Manassas Park,10290,51685,548,"Washington-Baltimore-Arlington, DC-MD-VA-WV-PA",14273,3983,0.3870748299319728
Winchester,23585,51840,548,"Washington-Baltimore-Arlington, DC-MD-VA-WV-PA",26203,2618,0.11100275598897605
Island,71558,53029,500,"Seattle-Tacoma, WA",78506,6948,0.09709606193577237
King,1737034,53033,500,"Seattle-Tacoma, WA",1931249,194215,0.11180840444113356
Kitsap,231969,53035,500,"Seattle-Tacoma, WA",251133,19164,0.08261448728062802
Lewis,68600,53041,500,"Seattle-Tacoma, WA",75455,6855,0.0999271137026239
Mason,49405,53045,500,"Seattle-Tacoma, WA",60699,11294,0.22860034409472726
Pierce,700820,53053,500,"Seattle-Tacoma, WA",795225,94405,0.13470648668702379
Skagit,102979,53057,500,"Seattle-Tacoma, WA",116901,13922,0.13519261208595929
Snohomish,606024,53061,500,"Seattle-Tacoma, WA",713335,107311,0.17707384526025371
Thurston,207355,53067,500,"Seattle-Tacoma, WA",252264,44909,0.21658026090521088
Berkeley,75905,54003,548,"Washington-Baltimore-Arlington, DC-MD-VA-WV-PA",104169,28264,0.3723601870759502
Hampshire,20203,54027,548,"Washington-Baltimore-Arlington, DC-MD-VA-WV-PA",23964,3761,0.18616047121714596
Jefferson,42190,54037,548,"Washington-Baltimore-Arlington, DC-MD-VA-WV-PA",53498,11308,0.26802559848305285
Kenosha,149577,55059,176,"Chicago-Naperville, IL-IN-WI",166426,16849,0.11264432365938613
Pierce,36804,55093,378,"Minneapolis-St. Paul, MN-WI",41019,4215,0.11452559504401695
St. Croix,63155,55109,378,"Minneapolis-St. Paul, MN-WI",84345,21190,0.3355237115034439
